The sun appears on the horizon.

Welcome to our Interactive Text-based RPG! We hope you enjoy your experience! When playing our game, make sure you have a look at the possible actions that can be taken!

GAME2500 RPG
An Interactive Fiction by James Napier
Release 1 / Serial number 201026 / Inform 7 build 6M62 (I6/v6.33 lib 6/12N) SD

Tenement
  You wake up to a sear of cold dripping on your head.

It's just water.

Nothing unusual; the neighbors above have had a dilapidated floor for months now. It's amazing that it hasn't given in entirely.

The unforgiving drops continue to pound mericlessly against your head - drilling into you the miserly state of your surroundings. Swerving from the next oncoming drip, you adjust yourself, and observe the other tenants in your room.

Like shadows, being just as thin and sulken, they all curl, and clutch to themselves as if to hold on to the meager remains of their life-force to their cagey bodies. Clothes are a laugh at this point, looking more like throwaway rags than anything else. Looking at them adds no hope to your already meager pile.

The dim rays of treacherous sunlight begin to blaze through the musty room, announcing the break of dawn. Work awaits. 

  Jones is the only other tenant that appears to be awake. It's only reasonable - how could he sleep? Nobody - not if they went through what he did. You feel the urge to approach him, but you're not sure if it's the right thing to do right now.

>e
Alley
  You stumble from the darkness of the tenement into the gloomy alley. It's eerily quiet as this time of day, but in a few minutes you know the crowds will come pouring out from every household you can see. Perhaps you should move quickly to avoid the rush. 

You pass a boy, yelling about the latest issue of the Boston Globe. He holds up the paper to your face and says "You want it, pal? Just 25 cents..." Your daily wage is about 50 cents. Is it really worth it?

The sun is now properly up.

>e
Front Gate
 After about 15 minutes of walking through a waking town, you have arrived at the factory front gate. Snakes of smoke pour from the high chimneys and hide the sun behind a screen of noxious white. The world lies in a dreamish haze. You see all the other factory laborers slowly filing in, and sigh at the thought of having to start your 11 hour shift.

>s
Main Entrance
  The hulking doors invite to swallow you in. You are hit by a gush of humid sweltry breeze - no, more than a breeze - it's the air you'll have to breathe now. "There won't be much to eat tonight," You think sardonically. This isn't your entrance; this is for the factory elites - the owner, the overseer, and their friends. It's a privilege to use the main entrance. Wage workers like you have to go the long way through the worker's entrance.

>w
Worker's Entrance
  The grim workers shuffle around the Mecca of the puncher. It bites savagely into the slim slivers of paper slipped into the cracked rusted box. You join the slow-moving hoard and punch in your strip of paper. Click.

>n
You can't go that way.

>s
You can't go that way.

>e
Main Entrance

>w
Worker's Entrance

>w
You can't go that way.

>s
You can't go that way.

* * *

>w
Worker's Entrance
  The grim workers shuffle around the Mecca of the puncher. It bites savagely into the slim slivers of paper slipped into the cracked rusted box. You join the slow-moving hoard and punch in your strip of paper. Click.

>s
Locker Rooms
  The first thing you notice as you walk into the locker rooms is the disgusting body odor radiating from every locker. You're unsure how to describe the sensation of the smell hitting your body: perhaps it slammed into your body? Either way, you're blinded momentarily by the horrid stench. After a few seconds that feel like an eternity, you regain your senses. You see the walls lined with tall metal lockers. A couple of benches are there on the ground for you to sit on while changing. 

You can see three benches here.

>e
Cotton Engines
As you work, the violent, periodic smashing of machinery forces itself into your head. You try to ignore it and focus on your cotton gin work, but every time you look at the machine, you can't help but picture what happened to Jones" wife. You shudder at the thought, and turn away from it in disgust for a bit, but then you think of the Overseer. The Overseer wouldn't like to see you distracted from your work.

You see the Overseer. The Overseer is heavy and muscular, with a large white beard and eyes you can barely make out, what with all the bags and wrinkles covering them up. He's somehow intimidating, despite the fact that it seems like his body could fall apart any second.

Your best friend, Winston, is working right next to you. He seems willing to talk.

You see the Overseer looking around impatiently, almost wanting to find something wrong with the place.
The Overseer heads to the Loading Dock.

>w
Locker Rooms
The first thing you notice as you walk into the locker rooms is the disgusting body odor radiating from every locker. You're unsure how to describe the sensation of the smell hitting your body: perhaps it slammed into your body? Either way, you're blinded momentarily by the horrid stench. After a few seconds that feel like an eternity, you regain your senses. You see the walls lined with tall metal lockers. A couple of benches are there on the ground for you to sit on while changing.

You can see some closed lockers lined up across the wall.

Interestingly, alongside the closed lockers are some unaccompanied open ones.

You can also see lone locker and three benches here.

>e
Cotton Engines
As you work, the violent, periodic smashing of machinery forces itself into your head. You try to ignore it and focus on your cotton gin work, but every time you look at the machine, you can't help but picture what happened to Jones" wife. You shudder at the thought, and turn away from it in disgust for a bit, but then you think of the Overseer. The Overseer wouldn't like to see you distracted from your work.

You see the Overseer. The Overseer is heavy and muscular, with a large white beard and eyes you can barely make out, what with all the bags and wrinkles covering them up. He's somehow intimidating, despite the fact that it seems like his body could fall apart any second.

Your best friend, Winston, is working right next to you. He seems willing to talk.

You see the Overseer looking around impatiently, almost wanting to find something wrong with the place.
The Overseer heads to the Spindle Room.

>s
Cotton Engines
As you work, the violent, periodic smashing of machinery forces itself in your head. You try to ignore it and focus on your cotton gin work, but every time you look at the thing, you can't help but picture what happened to Jones" wife. You shudder at the thought, and turn away from the machine for a bit, but there your boss is, staring in your soul with a furious glare. You turn back to the machine and keep working. 5 hours later, the machine whirring stops for lunch break. You only have 10 minutes. You see your friend Winston in the other corner of the room. Being the (slightly) more well-off of you two, he has lunch for both of you.

You can see Winston here.

>w
Locker Rooms

>s
You can't go that way.

>e
Spindle Room

* * *

>n
Spindle Room

>n
Intake Desk

>s
Spindle Room

>s
Cotton Engines
As you work, the violent, periodic smashing of machinery forces itself in your head. You try to ignore it and focus on your cotton gin work, but every time you look at the thing, you can't help but picture what happened to Jones" wife. You shudder at the thought, and turn away from the machine for a bit, but there your boss is, staring in your soul with a furious glare. You turn back to the machine and keep working. 5 hours later, the machine whirring stops for lunch break. You only have 10 minutes. You see your friend Winston in the other corner of the room. Being the (slightly) more well-off of you two, he has lunch for both of you.

You can see Winston here.

>s
Central Stairs
You can see Overseer here.

>examine Overseer
The Overseer glares at you. "What are you looking at. Get back to work".

>look
Central Stairs
You can see Overseer here.

>n
Cotton Engines
As you work, the violent, periodic smashing of machinery forces itself in your head. You try to ignore it and focus on your cotton gin work, but every time you look at the thing, you can't help but picture what happened to Jones" wife. You shudder at the thought, and turn away from the machine for a bit, but there your boss is, staring in your soul with a furious glare. You turn back to the machine and keep working. 5 hours later, the machine whirring stops for lunch break. You only have 10 minutes. You see your friend Winston in the other corner of the room. Being the (slightly) more well-off of you two, he has lunch for both of you.

You can see Winston here.

>n
Spindle Room

* * *

>e
Loading Dock
You feel a light gust of outdoor air. Still, you feel just as caged in as you would in the Cotton Engines; the air is still full of chimney smoke, and the sounds are just as grating as ever. It's hard to see anything ahead of you with so many stacks of boxes in the way. You see Randy - a balding, overweight man - organizing them in some way you can't understand.

>e
You can't go that way.

The Overseer arrives from Cotton Engines and stomps over to you, yelling "What are you doing here! Get back to work, or I'll dock your pay for the rest of the month!" You hurry back to the cotton engines.

Cotton Engines
As you work, the violent, periodic smashing of machinery forces itself into your head. You try to ignore it and focus on your cotton gin work, but every time you look at the machine, you can't help but picture what happened to Jones" wife. You shudder at the thought, and turn away from it in disgust for a bit, but then you think of the Overseer. The Overseer wouldn't like to see you distracted from your work.

Your best friend, Winston, is working right next to you. He seems willing to talk.

Well that was rude. Guess I should avoid him next time.

>w
Locker Rooms
The first thing you notice as you walk into the locker rooms is the disgusting body odor radiating from every locker. You're unsure how to describe the sensation of the smell hitting your body: perhaps it slammed into your body? Either way, you're blinded momentarily by the horrid stench. After a few seconds that feel like an eternity, you regain your senses. You see the walls lined with tall metal lockers. A couple of benches are there on the ground for you to sit on while changing.

You can see some closed lockers lined up across the wall.

Interestingly, alongside the closed lockers are some unaccompanied open ones.

You can also see lone locker and three benches here.

>w
You can't go that way.

>n
Worker's Entrance
As the workers file in, a young man yells at them to go faster. "If any'un sees you messin" around, you'll be outuvva job!" You didn't need any reminder of that.

>n
You can't go that way.

>e
Main Entrance
The hulking doors invite to swallow you in. You are hit by a gush of humid sweltry breeze - no, more than a breeze - it's the air you'll have to breathe now. "There won't be much to eat tonight," You think sardonically.

This isn't your entrance; this is for the factory elites - the owner, the overseer, and their friends. It's a privilege to use the main entrance. Wage workers like you have to go the long way through the worker's entrance.

>wait
Time passes.

>wait
Time passes.

>wait
Time passes.

The sun has passed across the sky and is on the verge of setting.
 You pack up your things and make your way through the Worker's Entrance towards home. Whatever happens at night in the Factory, you're not sure if you want to be there to see it.

Hit the SPACE to continue.

Tenement
You wake up to the drip of some cold water on your head. It's nothing unusual; the neighbors above have had a dilapidated floor for months now. It's amazing that it hasn't given in entirely. The unforgiving drops continue to pound mericlessly against your head - drilling in the miserly state of your surroundings. Swerving from the next oncoming drip, you adjust yourself, and observe other tenants in your room. Each of them are shells:  diminished beings curling, clutching themselves as if to hold on to the meager remains of their life-force in their cagey bodies. Clothes are a laugh at this point, looking more like throwaway rags than anything else. The dim rays of sunlight peek through the musty room, announcing the break of dawn. You force yourself out of bed. Work awaits.

Jones is the only other tenant that appears to be awake. It's only reasonable - how could he sleep? Nobody - not if they went through what he did. You feel the urge to approach him, but you're not sure if it's the right thing to do right now.

>e
Alley
You stumble from the darkness of the tenement into the gloomy alley. It's eerily quiet as this time of day, but in a few minutes you know the crowds will come pouring out from every household you can see. Perhaps you should move quickly to avoid the rush.

You pass a boy, yelling about the latest issue of the Boston Globe. He holds up the paper to your face and says "You want it, pal? Just 25 cents..." Your daily wage is about 50 cents. Is it really worth it?

>e
Front Gate
After about 15 minutes of walking, you finally show up at the factory front gate. Peeking through the clouds of smoke pouring from the chimneys, you can just barely tell that it's a sunny day.

You see all the other factory laborers slowly filing in, and sigh at the thought of having to start your 11 hour shift.

The sun falls below the horizon and the temperature drops abruptly to well below zero.

>s
Main Entrance
The hulking doors invite to swallow you in. You are hit by a gush of humid sweltry breeze - no, more than a breeze - it's the air you'll have to breathe now. "There won't be much to eat tonight," You think sardonically.

This isn't your entrance; this is for the factory elites - the owner, the overseer, and their friends. It's a privilege to use the main entrance. Wage workers like you have to go the long way through the worker's entrance.

>s
Intake Desk
You can see a desk chair and a reception desk (in which is a drawer (in which is a book)) here.

Jackie, flustered, says "What are you doing here!?" I have some strong words for that Overseer of yours." and blows a small whistle.
The Overseer stalks into the room, clearly angry that he heard the whistle.

* * *

>n
Worker's Entrance

>n
You can't go that way.

>e
Main Entrance
The hulking doors invite to swallow you in. You are hit by a gush of humid sweltry breeze - no, not a breeze, it is the air you are to breathe now. It slowly cooks you in, ready to service you to some other. "There won't be much to eat," You think sardonically. A small crowd of grim women shuffle around the Mecca of the puncher. It bites the slim slivers of paper.

>s
Intake Desk
You see Jackie, the company secretary, staring at the wall in silence as she sits at her reception desk. She glances at you quickly, taking on a suspicious expression, but then looks back, as if she has better things to do. Suddenly, she notices that you're looking at the book on her desk. It's hard to see what the title is, but instinctively, she grabs it and shoves it into the nearest drawer, locking it with a key.

Jackie, flustered, says "What are you doing here!?" I have some strong words for that Overseer of yours." and blows a small whistle.
The Overseer stalks into the room, clearly angry that he heard the whistle.

>s
Spindle Room
You see Robin, who is (like usual) gossiping with her neighbor. She's trying to be discrete, but it's hard not to hear her when she has to speak over the roar of the machines to be heard by anyone. You can't make our every word, but maybe if you listen more carefully, you'll get to hear something interesting…

The Overseer arrives from the Intake Desk and stomps over to you, yelling "What are you doing here! Get back to work, or I'll dock your pay for the rest of the month!" You hurry back to the cotton engines.

Cotton Engines
As you work, the violent, periodic smashing of machinery forces itself in your head. You try to ignore it and focus on your cotton gin work, but every time you look at the thing, you can't help but picture what happened to Jones" wife. You shudder at the thought, and turn away from the machine for a bit, but there your boss is, staring in your soul with a furious glare. You turn back to the machine and keep working.

You can see Winston here.

Well that was rude. Guess I should avoid him next time.

>w
Locker Rooms

>n
Worker's Entrance

* * *

>i
You are carrying nothing.

The Overseer stomps over to you, yelling "What are you doing here! Get back to work, or I'll dock your pay for the rest of the month!" You scurry back to the cotton engines
Cotton Engines
As you work, the violent, periodic smashing of machinery forces itself in your head. You try to ignore it and focus on your cotton gin work, but every time you look at the thing, you can't help but picture what happened to Jones" wife. You shudder at the thought, and turn away from the machine for a bit, but there your boss is, staring in your soul with a furious glare. You turn back to the machine and keep working.

You can see Winston here.

Well that was rude. Guess I should avoid him next time.

* * *

>n
Spindle Room

>n
Intake Desk
You can see Overseer here.

You see the Overseer looking around impatiently, almost wanting to find something wrong with the place.
The Overseer heads to the Spindle Room.

>s
Spindle Room
You can see Overseer here.

You see the Overseer looking around impatiently, almost wanting to find something wrong with the place.
You see the Overseer looking around impatiently, almost wanting to find something wrong with the place.
You see the Overseer looking around impatiently, almost wanting to find something wrong with the place.
You see the Overseer looking around impatiently, almost wanting to find something wrong with the place.
You see the Overseer looking around impatiently, almost wanting to find something wrong with the place.

* * *

>s
Central Stairs

>s
Boiler Room

>n
Central Stairs

>n
Cotton Engines
As you work, the violent, periodic smashing of machinery forces itself in your head. You try to ignore it and focus on your cotton gin work, but every time you look at the thing, you can't help but picture what happened to Jones" wife. You shudder at the thought, and turn away from the machine for a bit, but there your boss is, staring in your soul with a furious glare. You turn back to the machine and keep working. 5 hours later, the machine whirring stops for lunch break. You only have 10 minutes. You see your friend Winston in the other corner of the room. Being the (slightly) more well-off of you two, he has lunch for both of you.

You can see Winston here.

>n
Spindle Room
You can see Overseer here.

You see the Overseer looking around impatiently, almost wanting to find something wrong with the place.

>wait
Time passes.

You see the Overseer looking around impatiently, almost wanting to find something wrong with the place.

>wait
Time passes.

The Overseer heads to the Intake Desk.

>n
Intake Desk
You can see Overseer here.

You see the Overseer looking around impatiently, almost wanting to find something wrong with the place.

>wait
Time passes.

You see the Overseer looking around impatiently, almost wanting to find something wrong with the place.

>wait
Time passes.

You see the Overseer looking around impatiently, almost wanting to find something wrong with the place.

>wait
Time passes.

You see the Overseer looking around impatiently, almost wanting to find something wrong with the place.
The Overseer heads to the Spindle Room.

>wait
Time passes.

>wait
Time passes.

The Overseer arrives from the Spindle Room and stomps over to you, yelling "What are you doing here! Get back to work, or I'll dock your pay for the rest of the month!"

Cotton Engines
As you work, the violent, periodic smashing of machinery forces itself in your head. You try to ignore it and focus on your cotton gin work, but every time you look at the thing, you can't help but picture what happened to Jones" wife. You shudder at the thought, and turn away from the machine for a bit, but there your boss is, staring in your soul with a furious glare. You turn back to the machine and keep working. 5 hours later, the machine whirring stops for lunch break. You only have 10 minutes. You see your friend Winston in the other corner of the room. Being the (slightly) more well-off of you two, he has lunch for both of you.

You can see Winston here.

Cotton Engines
As you work, the violent, periodic smashing of machinery forces itself in your head. You try to ignore it and focus on your cotton gin work, but every time you look at the thing, you can't help but picture what happened to Jones" wife. You shudder at the thought, and turn away from the machine for a bit, but there your boss is, staring in your soul with a furious glare. You turn back to the machine and keep working. 5 hours later, the machine whirring stops for lunch break. You only have 10 minutes. You see your friend Winston in the other corner of the room. Being the (slightly) more well-off of you two, he has lunch for both of you.

You can see Winston here.

Well that was rude. Guess I should avoid him next time.

* * *

>wait
Time passes.

Overseer arrives from the Loading Dock and glares at you.

>wait
Time passes.

You see the Overseer looking around impatiently, almost wanting to find something wrong with the place.

>wait
Time passes.

You see the Overseer looking around impatiently, almost wanting to find something wrong with the place.
The Overseer heads to the Loading Dock.

>wait
Time passes.

Overseer arrives from the Loading Dock and glares at you.

>wait
Time passes.

You see the Overseer looking around impatiently, almost wanting to find something wrong with the place.
The Overseer heads to the Spindle Room.

>wait
Time passes.

Overseer arrives from the Spindle Room and glares at you.

>wait
Time passes.

You see the Overseer looking around impatiently, almost wanting to find something wrong with the place.

>wait
Time passes.

You see the Overseer looking around impatiently, almost wanting to find something wrong with the place.
The Overseer heads to Central Stairs.

>wait
Time passes.

>wait
Time passes.

Overseer arrives from Central Stairs and glares at you.

>wait
Time passes.

You see the Overseer looking around impatiently, almost wanting to find something wrong with the place.
The Overseer heads to Central Stairs.

The sun has passed across the sky and is on the verge of setting.
Winston gives you a grim smile, and says "See ya tomorrow ya sod" as he heads out towards the Locker Rooms.
 You pack up your things and make your way through the Worker's Entrance towards home. Whatever happens at night in the Factory, you're not sure if you want to be there to see it.

Hit the SPACE to continue.

>wait
Time passes.

>n
Spindle Room

* * *

>s
Central Stairs
You can see Overseer here.

You see the Overseer looking around impatiently, almost wanting to find something wrong with the place.

>wait
Time passes.

You see the Overseer looking around impatiently, almost wanting to find something wrong with the place.
The Overseer heads to the Boiler Room.

* * *

>wait
Time passes.

>wait
Time passes.

The sun has passed across the sky and is on the verge of setting.

>wait
Time passes.

The sun falls below the horizon and the temperature drops abruptly to well below zero.

>wait
Time passes.

>s
Central Stairs
You can see Overseer here.

You see the Overseer looking around impatiently, almost wanting to find something wrong with the place.
The Overseer stomps over to you, yelling "What are you doing here! Get back to work, or I'll dock your pay for the rest of the month!"

Cotton Engines
As you work, the violent, periodic smashing of machinery forces itself in your head. You try to ignore it and focus on your cotton gin work, but every time you look at the thing, you can't help but picture what happened to Jones" wife. You shudder at the thought, and turn away from the machine for a bit, but there your boss is, staring in your soul with a furious glare. You turn back to the machine and keep working. 5 hours later, the machine whirring stops for lunch break. You only have 10 minutes. You see your friend Winston in the other corner of the room. Being the (slightly) more well-off of you two, he has lunch for both of you.

You can see Winston here.

* * *

>wait
Time passes.

>look
Cotton Engines
As you work, the violent, periodic smashing of machinery forces itself in your head. You try to ignore it and focus on your cotton gin work, but every time you look at the thing, you can't help but picture what happened to Jones" wife. You shudder at the thought, and turn away from the machine for a bit, but there your boss is, staring in your soul with a furious glare. You turn back to the machine and keep working.

The overseer is heavy and muscular, with a large white beard and eyes you can barely make out, what with all the bags and wrinkles covering them up. He's somehow intimidating, despite the fact that it seems like his body could fall apart any second.

You can also see Winston here.

* * *

>asedw
That's not a verb I recognise.

* * *

>wait
Time passes.

You see the Overseer looking around impatiently, almost wanting to find something wrong with the place.

>s
Central Stairs
The Overseer is heavy and muscular, with a large white beard and eyes you can barely make out, what with all the bags and wrinkles covering them up. He's somehow intimidating, despite the fact that it seems like his body could fall apart any second.

The Overseer stomps over to you, yelling "What are you doing here! Get back to work, or I'll dock your pay for the rest of the month!" You scurry back to the cotton engines
Cotton Engines
As you work, the violent, periodic smashing of machinery forces itself in your head. You try to ignore it and focus on your cotton gin work, but every time you look at the thing, you can't help but picture what happened to Jones" wife. You shudder at the thought, and turn away from the machine for a bit, but there your boss is, staring in your soul with a furious glare. You turn back to the machine and keep working.

You can see Winston here.

Well that was rude. Guess I should avoid him next time.

>wait
Time passes.

* * *

>wait
Time passes.

The sun has passed across the sky and is on the verge of setting.

>it
That's not a verb I recognise.

>wait
Time passes.

The sun falls below the horizon and the temperature drops abruptly to well below zero.

The sun appears on the horizon.

The sun is now properly up.

The sun has passed across the sky and is on the verge of setting.

The sun falls below the horizon and the temperature drops abruptly to well below zero.

The sun appears on the horizon.

The sun is now properly up.

The sun has passed across the sky and is on the verge of setting.

The sun falls below the horizon and the temperature drops abruptly to well below zero.

The sun appears on the horizon.

The sun is now properly up.

The sun has passed across the sky and is on the verge of setting.

The sun falls below the horizon and the temperature drops abruptly to well below zero.

The sun appears on the horizon.

The sun is now properly up.

The sun has passed across the sky and is on the verge of setting.

The sun falls below the horizon and the temperature drops abruptly to well below zero.

The sun appears on the horizon.

The sun is now properly up.

The sun has passed across the sky and is on the verge of setting.

The sun falls below the horizon and the temperature drops abruptly to well below zero.

The sun appears on the horizon.
>--> The scene change machinery is stuck.

* * *

>wait
Time passes.

You see the Overseer looking around impatiently, almost wanting to find something wrong with the place.
The Overseer heads to the Spindle Room.

>e
Loading Dock
The Overseer is heavy and muscular, with a large white beard and eyes you can barely make out, what with all the bags and wrinkles covering them up. He's somehow intimidating, despite the fact that it seems like his body could fall apart any second.

The Overseer stomps over to you, yelling "What are you doing here! Get back to work, or I'll dock your pay for the rest of the month!" You scurry back to the cotton engines
Cotton Engines
As you work, the violent, periodic smashing of machinery forces itself in your head. You try to ignore it and focus on your cotton gin work, but every time you look at the thing, you can't help but picture what happened to Jones" wife. You shudder at the thought, and turn away from the machine for a bit, but there your boss is, staring in your soul with a furious glare. You turn back to the machine and keep working.

You can see Winston here.

Well that was rude. Guess I should avoid him next time.

>wait
Time passes.

>talk to Winston
You come up to him and he gives you the lunch bag.

>talk to Winston
You come up to him and he gives you the lunch bag.

>wait
Time passes.

>e
Loading Dock
The Overseer is heavy and muscular, with a large white beard and eyes you can barely make out, what with all the bags and wrinkles covering them up. He's somehow intimidating, despite the fact that it seems like his body could fall apart any second.

The Overseer stomps over to you, yelling "What are you doing here! Get back to work, or I'll dock your pay for the rest of the month!" You scurry back to the cotton engines
Cotton Engines
As you work, the violent, periodic smashing of machinery forces itself in your head. You try to ignore it and focus on your cotton gin work, but every time you look at the thing, you can't help but picture what happened to Jones" wife. You shudder at the thought, and turn away from the machine for a bit, but there your boss is, staring in your soul with a furious glare. You turn back to the machine and keep working.

You can see Winston here.

Well that was rude. Guess I should avoid him next time.

* * *

>wait
Time passes.

You see the Overseer looking around impatiently, almost wanting to find something wrong with the place.
The Overseer heads to the Spindle Room.

>wai
That's not a verb I recognise.

>wait
Time passes.

* * *

>wait
Time passes.

The sun falls below the horizon and the temperature drops abruptly to well below zero.

>look
Cotton Engines
As you work, the violent, periodic smashing of machinery forces itself into your head. You try to ignore it and focus on your cotton gin work, but every time you look at the machine, you can't help but picture what happened to Jones" wife. You shudder at the thought, and turn away from it in disgust for a bit, but then you think of the Overseer. The Overseer wouldn't like to see you distracted from your work.

* * *

>wait
Time passes.

Overseer arrives from the Loading Dock and glares at you.

>n
Spindle Room
The Overseer is heavy and muscular, with a large white beard and eyes you can barely make out, what with all the bags and wrinkles covering them up. He's somehow intimidating, despite the fact that it seems like his body could fall apart any second.

You see Robin, who is (like usual) gossiping with her neighbor. She's trying to be discrete, but it's hard not to hear her when she has to speak over the roar of the machines to be heard by anyone. You can't make our every word, but maybe if you listen more carefully, you'll get to hear something interesting…

The Overseer stomps over to you, yelling "What are you doing here! Get back to work, or I'll dock your pay for the rest of the month!" You scurry back to the cotton engines
Cotton Engines
As you work, the violent, periodic smashing of machinery forces itself in your head. You try to ignore it and focus on your cotton gin work, but every time you look at the thing, you can't help but picture what happened to Jones" wife. You shudder at the thought, and turn away from the machine for a bit, but there your boss is, staring in your soul with a furious glare. You turn back to the machine and keep working.

You can see Winston here.

Well that was rude. Guess I should avoid him next time.

>wait
Time passes.

>ait
That's not a verb I recognise.

>wait
Time passes.

The sun has passed across the sky and is on the verge of setting.

>wait
Time passes.

The sun falls below the horizon and the temperature drops abruptly to well below zero.

The sun appears on the horizon.

The sun is now properly up.

The sun has passed across the sky and is on the verge of setting.

The sun falls below the horizon and the temperature drops abruptly to well below zero.

The sun appears on the horizon.

The sun is now properly up.

The sun has passed across the sky and is on the verge of setting.

The sun falls below the horizon and the temperature drops abruptly to well below zero.

The sun appears on the horizon.

The sun is now properly up.

The sun has passed across the sky and is on the verge of setting.

The sun falls below the horizon and the temperature drops abruptly to well below zero.

The sun appears on the horizon.

The sun is now properly up.

The sun has passed across the sky and is on the verge of setting.

The sun falls below the horizon and the temperature drops abruptly to well below zero.

The sun appears on the horizon.

The sun is now properly up.

The sun has passed across the sky and is on the verge of setting.

The sun falls below the horizon and the temperature drops abruptly to well below zero.

The sun appears on the horizon.
>--> The scene change machinery is stuck.

>wait
Time passes.

The sun is now properly up.

The sun has passed across the sky and is on the verge of setting.

The sun falls below the horizon and the temperature drops abruptly to well below zero.

The sun appears on the horizon.

The sun is now properly up.

The sun has passed across the sky and is on the verge of setting.

The sun falls below the horizon and the temperature drops abruptly to well below zero.

The sun appears on the horizon.

The sun is now properly up.

The sun has passed across the sky and is on the verge of setting.

The sun falls below the horizon and the temperature drops abruptly to well below zero.

The sun appears on the horizon.

The sun is now properly up.

The sun has passed across the sky and is on the verge of setting.

The sun falls below the horizon and the temperature drops abruptly to well below zero.

The sun appears on the horizon.

The sun is now properly up.

The sun has passed across the sky and is on the verge of setting.

The sun falls below the horizon and the temperature drops abruptly to well below zero.

The sun appears on the horizon.

The sun is now properly up.

The sun has passed across the sky and is on the verge of setting.
>--> The scene change machinery is stuck.

The sun falls below the horizon and the temperature drops abruptly to well below zero.

The sun appears on the horizon.

The sun is now properly up.

The sun has passed across the sky and is on the verge of setting.

The sun falls below the horizon and the temperature drops abruptly to well below zero.

The sun appears on the horizon.

The sun is now properly up.

The sun has passed across the sky and is on the verge of setting.

The sun falls below the horizon and the temperature drops abruptly to well below zero.

The sun appears on the horizon.

The sun is now properly up.

The sun has passed across the sky and is on the verge of setting.

The sun falls below the horizon and the temperature drops abruptly to well below zero.

The sun appears on the horizon.

The sun is now properly up.

The sun has passed across the sky and is on the verge of setting.

The sun falls below the horizon and the temperature drops abruptly to well below zero.

The sun appears on the horizon.

The sun is now properly up.

The sun has passed across the sky and is on the verge of setting.

The sun falls below the horizon and the temperature drops abruptly to well below zero.

The sun appears on the horizon.
>--> The scene change machinery is stuck.

* * *

>wait
Time passes.

You see the Overseer looking around impatiently, almost wanting to find something wrong with the place.
The Overseer heads to the Loading Dock.

>awit
That's not a verb I recognise.

>wait
Time passes.

You see the Overseer looking around impatiently, almost wanting to find something wrong with the place.

* * *

>wait
Time passes.

You see the Overseer looking around impatiently, almost wanting to find something wrong with the place.
The Overseer heads to the Loading Dock.

>e
Loading Dock
You can see Overseer here.

You see the Overseer looking around impatiently, almost wanting to find something wrong with the place.
The Overseer heads to Cotton Engines.

* * *

>wait
Time passes.

You see the Overseer looking around impatiently, almost wanting to find something wrong with the place.
The Overseer heads to the Loading Dock.

>look north
You make out the Spindle Room that way.

>n
Spindle Room
You see Robin, who is (like usual) gossiping with her neighbor. She's trying to be discrete, but it's hard not to hear her when she has to speak over the roar of the machines to be heard by anyone. You can't make our every word, but maybe if you listen more carefully, you'll get to hear something interesting…

The Overseer arrives from the Intake Desk and stomps over to you, yelling "What are you doing here! Get back to work, or I'll dock your pay for the rest of the month!" You hurry back to the cotton engines.

Cotton Engines
As you work, the violent, periodic smashing of machinery forces itself in your head. You try to ignore it and focus on your cotton gin work, but every time you look at the thing, you can't help but picture what happened to Jones" wife. You shudder at the thought, and turn away from the machine for a bit, but there your boss is, staring in your soul with a furious glare. You turn back to the machine and keep working.

You can see Winston here.

Well that was rude. Guess I should avoid him next time.

>wait
Time passes.

The sun has passed across the sky and is on the verge of setting.

* * *

>wait
Time passes.

The sun falls below the horizon and the temperature drops abruptly to well below zero.

>wait
Time passes.

Overseer arrives from the Spindle Room and glares at you.

* * *

>wait
Time passes.

You see the Overseer looking around impatiently, almost wanting to find something wrong with the place.

>wait
Time passes.

You see the Overseer looking around impatiently, almost wanting to find something wrong with the place.

The sun appears on the horizon.

>wait
Time passes.

You see the Overseer looking around impatiently, almost wanting to find something wrong with the place.
The Overseer heads to Central Stairs.

The sun is now properly up.

* * *

>wait
Time passes.

You see the Overseer looking around impatiently, almost wanting to find something wrong with the place.
The Overseer heads to the Loading Dock.

>s
Central Stairs
The Overseer is heavy and muscular, with a large white beard and eyes you can barely make out, what with all the bags and wrinkles covering them up. He's somehow intimidating, despite the fact that it seems like his body could fall apart any second.

The Overseer stomps over to you, yelling "What are you doing here! Get back to work, or I'll dock your pay for the rest of the month!" You scurry back to the cotton engines
Cotton Engines
As you work, the violent, periodic smashing of machinery forces itself in your head. You try to ignore it and focus on your cotton gin work, but every time you look at the thing, you can't help but picture what happened to Jones" wife. You shudder at the thought, and turn away from the machine for a bit, but there your boss is, staring in your soul with a furious glare. You turn back to the machine and keep working.

You can see Winston here.

Well that was rude. Guess I should avoid him next time.

* * *

>wait
Time passes.

You see the Overseer looking around impatiently, almost wanting to find something wrong with the place.
The Overseer heads to the Loading Dock.

>e
Loading Dock
The Overseer is heavy and muscular, with a large white beard and eyes you can barely make out, what with all the bags and wrinkles covering them up. He's somehow intimidating, despite the fact that it seems like his body could fall apart any second.

The Overseer stomps over to you, yelling "What are you doing here! Get back to work, or I'll dock your pay for the rest of the month!" You scurry back to the cotton engines
Cotton Engines
As you work, the violent, periodic smashing of machinery forces itself in your head. You try to ignore it and focus on your cotton gin work, but every time you look at the thing, you can't help but picture what happened to Jones" wife. You shudder at the thought, and turn away from the machine for a bit, but there your boss is, staring in your soul with a furious glare. You turn back to the machine and keep working.

You can see Winston here.

Well that was rude. Guess I should avoid him next time.

* * *

>look
Cotton Engines
As you work, the violent, periodic smashing of machinery forces itself in your head. You try to ignore it and focus on your cotton gin work, but every time you look at the thing, you can't help but picture what happened to Jones" wife. You shudder at the thought, and turn away from the machine for a bit, but there your boss is, staring in your soul with a furious glare. You turn back to the machine and keep working.

The Overseer is heavy and muscular, with a large white beard and eyes you can barely make out, what with all the bags and wrinkles covering them up. He's somehow intimidating, despite the fact that it seems like his body could fall apart any second.

You can also see Winston here.

>examine the Overseer
The Overseer glares at you. "What are you looking at. Get back to work".

The sun appears on the horizon.

>wait
Time passes.

The sun is now properly up.

>look
Cotton Engines
As you work, the violent, periodic smashing of machinery forces itself in your head. You try to ignore it and focus on your cotton gin work, but every time you look at the thing, you can't help but picture what happened to Jones" wife. You shudder at the thought, and turn away from the machine for a bit, but there your boss is, staring in your soul with a furious glare. You turn back to the machine and keep working.

The Overseer is heavy and muscular, with a large white beard and eyes you can barely make out, what with all the bags and wrinkles covering them up. He's somehow intimidating, despite the fact that it seems like his body could fall apart any second.

You can also see Winston here.

>wait
Time passes.

* * *

>s
Locker Rooms
  The first thing you notice as you walk into the locker rooms is the disgusting body odor radiating from every locker. You're unsure how to describe the sensation of the smell hitting your body: perhaps it slammed into your body? Either way, you're blinded momentarily by the horrid stench. After a few seconds that feel like an eternity, you regain your senses. You see the walls lined with tall metal lockers. A couple of benches are there on the ground for you to sit on while changing. 

You can see three benches here.

>n
Worker's Entrance

>e
Main Entrance
The hulking doors invite to swallow you in. You are hit by a gush of humid sweltry breeze - no, not a breeze, it is the air you are to breathe now. It slowly cooks you in, ready to service you to some other. "There won't be much to eat," You think sardonically. A small crowd of grim women shuffle around the Mecca of the puncher. It bites the slim slivers of paper.

* * *

>talk to Jackie
Who?

The Overseer stomps over to you, yelling "What are you doing here! Get back to work, or I'll dock your pay for the rest of the month!" You scurry back to the cotton engines
Cotton Engines
As you work, the violent, periodic smashing of machinery forces itself in your head. You try to ignore it and focus on your cotton gin work, but every time you look at the thing, you can't help but picture what happened to Jones" wife. You shudder at the thought, and turn away from the machine for a bit, but there your boss is, staring in your soul with a furious glare. You turn back to the machine and keep working.

You can see Winston here.

Well that was rude. Guess I should avoid him next time.

>n
Spindle Room
You see Robin, who is (like usual) gossiping with her neighbor. She's trying to be discrete, but it's hard not to hear her when she has to speak over the roar of the machines to be heard by anyone. You can't make our every word, but maybe if you listen more carefully, you'll get to hear something interesting…

>wait
Time passes.

>n
Intake Desk
The Overseer is heavy and muscular, with a large white beard and eyes you can barely make out, what with all the bags and wrinkles covering them up. He's somehow intimidating, despite the fact that it seems like his body could fall apart any second.

You see Jackie, the company secretary, staring at the wall in silence as she sits at her reception desk. She glances at you quickly, taking on a suspicious expression, but then looks back, as if she has better things to do. Suddenly, she notices that you're looking at the book on her desk. It's hard to see what the title is, but instinctively, she grabs it and shoves it into the nearest drawer, locking it with a key.

The Overseer stomps over to you, yelling "What are you doing here! Get back to work, or I'll dock your pay for the rest of the month!" You scurry back to the cotton engines
Cotton Engines
As you work, the violent, periodic smashing of machinery forces itself in your head. You try to ignore it and focus on your cotton gin work, but every time you look at the thing, you can't help but picture what happened to Jones" wife. You shudder at the thought, and turn away from the machine for a bit, but there your boss is, staring in your soul with a furious glare. You turn back to the machine and keep working.

You can see Winston here.

Well that was rude. Guess I should avoid him next time.

* * *

>s
Locker Rooms
  The first thing you notice as you walk into the locker rooms is the disgusting body odor radiating from every locker. You're unsure how to describe the sensation of the smell hitting your body: perhaps it slammed into your body? Either way, you're blinded momentarily by the horrid stench. After a few seconds that feel like an eternity, you regain your senses. You see the walls lined with tall metal lockers. A couple of benches are there on the ground for you to sit on while changing. 

You can see three benches here.

>examine the closed lockers
You try and peer through the small slits on each locker door, but ultimately the stench emanating stench is too much from each locker to investigate the closed lockers thoroughly.

>examine the open lockers
You see some of the lockers are left open during the day. Unfortunately, it isn't the locker of anyone important. You take a peek through all of the doors and nothing of interest seems to be inside…

That is, until you get to a lone damaged locker on the back right of the room. From afar, it looks as though it was locked, but as you get closer you see that the lock has actually been damaged and can now be opened.

>e
Cotton Engines
As you work, the violent, periodic smashing of machinery forces itself into your head. You try to ignore it and focus on your cotton gin work, but every time you look at the machine, you can't help but picture what happened to Jones" wife. You shudder at the thought, and turn away from it in disgust for a bit, but then you think of the Overseer. The Overseer wouldn't like to see you distracted from your work.

You see the Overseer. The Overseer is heavy and muscular, with a large white beard and eyes you can barely make out, what with all the bags and wrinkles covering them up. He's somehow intimidating, despite the fact that it seems like his body could fall apart any second.

Your best friend, Winston, is working right next to you. He seems willing to talk.

You see the Overseer looking around impatiently, almost wanting to find something wrong with the place.
The Overseer heads to the Spindle Room.

>w
Locker Rooms
The first thing you notice as you walk into the locker rooms is the disgusting body odor radiating from every locker. You're unsure how to describe the sensation of the smell hitting your body: perhaps it slammed into your body? Either way, you're blinded momentarily by the horrid stench. After a few seconds that feel like an eternity, you regain your senses. You see the walls lined with tall metal lockers. A couple of benches are there on the ground for you to sit on while changing.

You can see some closed lockers lined up across the wall.

Interestingly, alongside the closed lockers are some unaccompanied open ones.

You can also see three benches here.

>look
Locker Rooms
The first thing you notice as you walk into the locker rooms is the disgusting body odor radiating from every locker. You're unsure how to describe the sensation of the smell hitting your body: perhaps it slammed into your body? Either way, you're blinded momentarily by the horrid stench. After a few seconds that feel like an eternity, you regain your senses. You see the walls lined with tall metal lockers. A couple of benches are there on the ground for you to sit on while changing.

You can see some closed lockers lined up across the wall.

Interestingly, alongside the closed lockers are some unaccompanied open ones.

You can also see three benches here.

* * *

>s
Locker Rooms
  The first thing you notice as you walk into the locker rooms is the disgusting body odor radiating from every locker. You're unsure how to describe the sensation of the smell hitting your body: perhaps it slammed into your body? Either way, you're blinded momentarily by the horrid stench. After a few seconds that feel like an eternity, you regain your senses. You see the walls lined with tall metal lockers. A couple of benches are there on the ground for you to sit on while changing. 

You can see three benches here.

>examine the metal lockers
You try and peer through the small slits on the closed locker doors, but ultimately the stench is too much from each locker to investigate them thoroughly.

Then, you examine the lockers that have been left open. Unfortunately, none of them are for anyone important. You take a peek through all of the doors and nothing of interest seems to be inside…

That is, until you get to a lone broken locker on the back right of the room. From afar, it looks as though it was locked, but as you get closer you see that the lock has actually been broken and can now be opened.

>look
Locker Rooms
  The first thing you notice as you walk into the locker rooms is the disgusting body odor radiating from every locker. You're unsure how to describe the sensation of the smell hitting your body: perhaps it slammed into your body? Either way, you're blinded momentarily by the horrid stench. After a few seconds that feel like an eternity, you regain your senses. You see the walls lined with tall metal lockers. A couple of benches are there on the ground for you to sit on while changing.

A broken locker stands hidden in the corner, its lock damaged so badly that it no longer functions. You might be able to open this. 

You can see three benches here.

>n
Worker's Entrance
  The grim workers shuffle around the Mecca of the puncher. It bites savagely into the slim slivers of paper slipped into the cracked rusted box. You join the slow-moving hoard and punch in your strip of paper. Click.

>n
You can't go that way.

>e
Main Entrance
  The hulking doors invite to swallow you in. You are hit by a gush of humid sweltry breeze - no, more than a breeze - it's the air you'll have to breathe now. "There won't be much to eat tonight," You think sardonically. This isn't your entrance; this is for the factory elites - the owner, the overseer, and their friends. It's a privilege to use the main entrance. Wage workers like you have to go the long way through the worker's entrance.

>n
Front Gate
 After about 15 minutes of walking through a waking town, you have arrived at the factory front gate. Snakes of smoke pour from the high chimneys and hide the sun behind a screen of noxious white. The world lies in a dreamish haze. You see all the other factory laborers slowly filing in, and sigh at the thought of having to start your 11 hour shift.

>wait
Time passes.

>wait
Time passes.

The sun has taken its journey through the sky and is on the verge of setting.

>wait
Time passes.

The sun falls below the horizon and the temperature drops. Best not be out for too long.

>s
Main Entrance
  The Main Factory Door is wide open. You're surprised at first, but you recall that the Overseer has been forgetful about these kinds of things. You assume that he just forgot to close it.

>w
Worker's Entrance
  You feel an uncomfortably cold gust of wind cross your body as you approach the Worker's Entrance.

>s
Locker Rooms
  The smell of the locker room is only slightly less horrendous at night - but the added darkness makes that smell all your mind can process. You see the walls lined with tall metal lockers. A couple of benches are there on the ground for you to sit on.

A broken locker stands hidden in the corner, its lock damaged so badly that it no longer functions. You might be able to open this.

You can see three benches here.

>e
Cotton Engines
  It's so dark inside the Cotton Engines that you almost stab yourself on the harsher end of a machine. At this point, you start to hear a strange periodic whirring, but it's hard to tell where it is, or what it could be coming from.

>s
Central Stairs
  You remember where you are just in time to avoid losing your sense of direction and falling down the staircase. That whirring you heard in the Cotton Engines is intensifying. Getting louder. More violent. More painful. It's starting to grind on your senses. Where is it?

You see the Overseer. The Overseer is heavy and muscular, with a large white beard and eyes you can barely make out, what with all the bags and wrinkles covering them up. He's somehow intimidating, despite the fact that it seems like his body could fall apart any second.

Right then and there, the Overseer stomps over to you, yelling "What are you doing here! Get back to work, or I'll dock your pay for the rest of the month!" You scurry back to the cotton engines.

Cotton Engines
  It's so dark inside the Cotton Engines that you almost stab yourself on the harsher end of a machine. At this point, you start to hear a strange periodic whirring, but it's hard to tell where it is, or what it could be coming from.

(Well, that was rude. Guess I should avoid him next time.)

* * *

>s
Locker Rooms
  The first thing you notice as you walk into the locker rooms is the disgusting body odor radiating from every locker. You're unsure how to describe the sensation of the smell hitting your body: perhaps it slammed into your body? Either way, you're blinded momentarily by the horrid stench. After a few seconds that feel like an eternity, you regain your senses. You see the walls lined with tall metal lockers. A couple of benches are there on the ground for you to sit on while changing. 

You can see three benches here.

>wait
Time passes.

>look
Locker Rooms
  The first thing you notice as you walk into the locker rooms is the disgusting body odor radiating from every locker. You're unsure how to describe the sensation of the smell hitting your body: perhaps it slammed into your body? Either way, you're blinded momentarily by the horrid stench. After a few seconds that feel like an eternity, you regain your senses. You see the walls lined with tall metal lockers. A couple of benches are there on the ground for you to sit on while changing. 

You can see three benches here.

>wait
Time passes.

The sun has taken its journey through the sky and is on the verge of setting.
 It's dusk. You pack up your things and make your way through the Worker's Entrance towards home. Whatever happens at night in the Factory, you're not sure if you want to be there to see it. Hit SPACE to continue.

Tenement
  You're back home. Your bed is right there, and you feel a strong urge to sleep, but at the same time you can't stop thinking about the factory. 

  You look at Jones to see if he's been doing any better, but there he is, already asleep.

>e
Alley
  You walk stealthily through the alley, hoping that nobody will detect you and think you're a thief. (Who else is going to be walking here at this time of night?) It's strangely peaceful, with the full moon directly overhead.

>e
Front Gate
 It's a rare sight to see the factory completely free of noxious smoke. You almost start feeling pleasant, but then you hear the echo of a loud crash. It seems like it came inside the factory. Suddenly, your mind races, as infinite fears - rational and irrational - cross your mind. Is the Overseer still here? Is someone getting killed? Are the machines acting up? You wonder if it's safe to be here at this hour.

>s
Main Entrance
  The Main Factory Door is wide open. You're surprised at first, but you recall that the Overseer has been forgetful about these kinds of things. You assume that he just forgot to close it.

>w
Worker's Entrance
  You feel an uncomfortably cold gust of wind cross your body as you approach the Worker's Entrance.

The sun falls below the horizon and the temperature plunges to well below zero.

* * *

>s
Main Entrance
  The hulking doors invite to swallow you in. You are hit by a gush of humid sweltry breeze - no, more than a breeze - it's the air you'll have to breathe now. "There won't be much to eat tonight," You think sardonically. This isn't your entrance; this is for the factory elites - the owner, the overseer, and their friends. It's a privilege to use the main entrance. Wage workers like you have to go the long way through the worker's entrance.

>s
Intake Desk
You see Jackie, the company secretary, staring at the wall in silence as she sits at her reception desk. She glances at you quickly, taking on a suspicious expression, but then looks back, as if she has better things to do. Suddenly, she notices that you're looking at the book on her desk. It's hard to see what the title is, but instinctively, she grabs it and shoves it into the nearest drawer, locking it with a key.

Jackie, flustered, says "What are you doing here!?" I have some strong words for that Overseer of yours." and blows a small whistle.

>s
Spindle Room

>listen
You hear the Whisper whisper whisper from the Spindle Room Gossip.

>look
Spindle Room
The Overseer arrives from Cotton Engines and stomps over to you, yelling "What are you doing here! Get back to work, or I'll dock your pay for the rest of the month!"

Cotton Engines
As you work, the violent, periodic smashing of machinery forces itself in your head. You try to ignore it and focus on your cotton gin work, but every time you look at the thing, you can't help but picture what happened to Jones" wife. You shudder at the thought, and turn away from the machine for a bit, but there your boss is, staring in your soul with a furious glare. You turn back to the machine and keep working.

You can see Winston here.

Well that was rude. Guess I should avoid him next time.

* * *

>s
Intake Desk
You see Jackie, the company secretary, staring at the wall in silence as she sits at her reception desk. She glances at you quickly, taking on a suspicious expression, but then looks back, as if she has better things to do. Suddenly, she notices that you're looking at the book on her desk. It's hard to see what the title is, but instinctively, she grabs it and shoves it into the nearest drawer, locking it with a key.

Jackie, flustered, says "What are you doing here!?" I have some strong words for that Overseer of yours." and blows a small whistle.

>wait
Time passes.

The Overseer stomps over to you, yelling "What are you doing here! Get back to work, or I'll dock your pay for the rest of the month!" You scurry back to the cotton engines
Cotton Engines
As you work, the violent, periodic smashing of machinery forces itself in your head. You try to ignore it and focus on your cotton gin work, but every time you look at the thing, you can't help but picture what happened to Jones" wife. You shudder at the thought, and turn away from the machine for a bit, but there your boss is, staring in your soul with a furious glare. You turn back to the machine and keep working.

You can see Winston here.

Well that was rude. Guess I should avoid him next time.

* * *

>s
Main Entrance
  The hulking doors invite to swallow you in. You are hit by a gush of humid sweltry breeze - no, more than a breeze - it's the air you'll have to breathe now. "There won't be much to eat tonight," You think sardonically. This isn't your entrance; this is for the factory elites - the owner, the overseer, and their friends. It's a privilege to use the main entrance. Wage workers like you have to go the long way through the worker's entrance.

>e
You can't go that way.

>n
Front Gate
After about 15 minutes of walking, you finally show up at the factory front gate. Peeking through the clouds of smoke pouring from the chimneys, you can just barely tell that it's a sunny day.

You see all the other factory laborers slowly filing in, and sigh at the thought of having to start your 11 hour shift.

>wait
Time passes.

* * *

>e
Alley
You stumble from the darkness of the tenement into the gloomy alley. It's eerily quiet as this time of day, but in a few minutes you know the crowds will come pouring out from every household you can see. Perhaps you should move quickly to avoid the rush.

You pass a boy, yelling about the latest issue of the Boston Globe. He holds up the paper to your face and says "You want it, pal? Just 25 cents..." Your daily wage is about 50 cents. Is it really worth it?

>e
Front Gate
After about 15 minutes of walking, you finally show up at the factory front gate. Peeking through the clouds of smoke pouring from the chimneys, you can just barely tell that it's a sunny day.

You see all the other factory laborers slowly filing in, and sigh at the thought of having to start your 11 hour shift.

>s
Main Entrance
The hulking doors invite to swallow you in. You are hit by a gush of humid sweltry breeze - no, more than a breeze - it's the air you'll have to breathe now. "There won't be much to eat tonight," You think sardonically.

This isn't your entrance; this is for the factory elites - the owner, the overseer, and their friends. It's a privilege to use the main entrance. Wage workers like you have to go the long way through the worker's entrance.

>w
Worker's Entrance
As the workers file in, a young man yells at them to go faster. "If any'un sees you messin" around, you'll be outuvva job!" You didn't need any reminder of that.

The sun falls below the horizon and the temperature drops abruptly to well below zero.

>s
Locker Rooms
The first thing you notice as you walk into the locker rooms is the disgusting body odor radiating from every locker. You're unsure how to describe the sensation of the smell hitting your body: perhaps it slammed into your body? Either way, you're blinded momentarily by the horrid stench. After a few seconds that feel like an eternity, you regain your senses. You see the walls lined with tall metal lockers. A couple of benches are there on the ground for you to sit on while changing.

You can see three benches here.

>examine the metal lockers
You see some of the lockers are left open during the day. Unfortunately, it isn't the locker of anyone important. You take a peek through all of the doors and nothing of interest seems to be inside…

You try and peer through the small slits on each locker door, but ultimately the stench emanating stench is too much from each locker to investigate the closed lockers thoroughly.

That is, until you get to a lone damaged locker on the back right of the room. From afar, it looks as though it was locked, but as you get closer you see that the lock has actually been damaged and can now be opened.

>open the damaged locker
You can't see any such thing.

* * *

>look in the broken locker
In the broken locker is a Mysterious Key.

>close the broken locker
You close the broken locker.

* * *

>close the broken locker
That's already closed.

* * *

>e
Front Gate
 After about 15 minutes of walking through a waking town, you have arrived at the factory front gate. Snakes of smoke pour from the high chimneys and hide the sun behind a screen of noxious white. The world lies in a dreamish haze. You see all the other factory laborers slowly filing in, and sigh at the thought of having to start your 11 hour shift.

>e
You can't go that way.

You see the Overseer looking around impatiently, almost wanting to find something wrong with the place.

>s
Main Entrance
You see the Overseer looking around impatiently, almost wanting to find something wrong with the place.

>s
Intake Desk
You see the Overseer looking around impatiently, almost wanting to find something wrong with the place.

>s
Spindle Room

* * *

>talk to Winston
You come up to him and he gives you the lunch bag.
He says...

>i
You are carrying:
  a lunch bag

>open a lunch bag
It isn't something you can open.

>n
Spindle Room

* * *

>n
Intake Desk

>n
Main Entrance

>n
Front Gate
After about 10 minutes of walking, you finally show up at the factory front gate. Peeking through the clouds of smoke pouring from the chimneys, you can just barely tell that it's a sunny day. You see all the other factory workers slowly filing in. Will you walk into the factory? As soon as you walk into the factory, you'll be starting your 11-hour shift.

>w
Alley
You stumble from the darkness of the tenement into the gloomy alley. It's eerily quiet as this time of day, but in a few minutes you know the crowds will come pouring out from every household you can see. Perhaps you should move quickly to avoid the rush.

You pass a newspaper boy, yelling about the latest issue of the Boston Globe. He holds up the paper to your face and says "You want it, pal? Just 25 cents..." Your daily wage is about 50 cents. Is it really worth it?

>buy the newspaper
Well, there goes your quarter. This better be good....

The paper is dated October 4, 1872. Seems to be a high end newspaper, because you can't understand many of the words. There is, however, one section that catches your eye.

"Cotton Gin accident leaves Factory Worker Dead"

The paper then explained what had happened to Jones" wife. She got too close to the machine, the paper said, and before she knew it, it sucked her in, mechanically splitting her body into scattered parts and organs. Only some of her remains were found.

You knew about this event well; it was in your own factory. But you hadn't seen the event take place, so it was interesting to see the details somewhere - especially when the company itself has been completely silent.

You doubt that it'll break its silence any time soon, either.

>i
You are carrying:
  a newspaper
  a lunch bag

* * *

>e
Front Gate
 After about 15 minutes of walking through a waking town, you have arrived at the factory front gate. Snakes of smoke pour from the high chimneys and hide the sun behind a screen of noxious white. The world lies in a dreamish haze. You see all the other factory laborers slowly filing in, and sigh at the thought of having to start your 11 hour shift.

>w
Alley
  You stumble from the darkness of the tenement into the gloomy alley. It's eerily quiet as this time of day, but in a few minutes you know the crowds will come pouring out from every household you can see. Perhaps you should move quickly to avoid the rush. 

You pass a boy, yelling about the latest issue of the Boston Globe. He holds up the paper to your face and says "You want it, pal? Just 25 cents..." Your daily wage is about 50 cents. Is it really worth it?

>buy the paper
Well, there goes your quarter. This better be good....

The paper is dated October 4, 1872. Seems to be a high end newspaper, because you can't understand many of the words. There is, however, one section that catches your eye.

"Cotton Gin Accident leaves Factory Worker Dead"

The paper then explained what had happened to Jones" wife. She got too close to the machine, the paper said, and before she knew it, it sucked her in and tore her apart. Only some of her remains were found.

You knew about this event well; it was in your own factory. But you hadn't seen the event take place, so it was interesting to see the details somewhere - especially when the company itself has been completely silent.

You doubt that it'll break the silence any time soon, either.

>examine the paper
You see nothing special about or paper.

>examine the newspaper
You see nothing special about the newspaper.

* * *

>w
Alley
  You stumble from the darkness of the tenement into the gloomy alley. It's eerily quiet as this time of day, but in a few minutes you know the crowds will come pouring out from every household you can see. Perhaps you should move quickly to avoid the rush. 

You pass a boy, yelling about the latest issue of the Boston Globe. He holds up the paper to your face and says "You want it, pal? Just 25 cents..." Your daily wage is about 50 cents. Is it really worth it?

>examine the paper
You see nothing special about paper.

>examine the newspaper
You see nothing special about the newspaper.

* * *

>e
Front Gate
 After about 15 minutes of walking through a waking town, you have arrived at the factory front gate. Snakes of smoke pour from the high chimneys and hide the sun behind a screen of noxious white. The world lies in a dreamish haze. You see all the other factory laborers slowly filing in, and sigh at the thought of having to start your 11 hour shift.

I beg your pardon?

>w
Alley
You stumble from the darkness of the tenement into the gloomy alley. It's eerily quiet as this time of day, but in a few minutes you know the crowds will come pouring out from every household you can see. Perhaps you should move quickly to avoid the rush.

You pass a boy, yelling about the latest issue of the Boston Globe. He holds up the paper to your face and says "You want it, pal? Just 25 cents..." Your daily wage is about 50 cents. Is it really worth it?

>s
You can't go that way.

>e
Front Gate
After about 15 minutes of walking, you finally show up at the factory front gate. Peeking through the clouds of smoke pouring from the chimneys, you can just barely tell that it's a sunny day.

You see all the other factory laborers slowly filing in, and sigh at the thought of having to start your 11 hour shift.

* * *

>s
Main Entrance
The hulking doors invite to swallow you in. You are hit by a gush of humid sweltry breeze - no, more than a breeze - it's the air you'll have to breathe now. "There won't be much to eat tonight," You think sardonically.

This isn't your entrance; this is for the factory elites - the owner, the overseer, and their friends. It's a privilege to use the main entrance. Wage workers like you have to go the long way through the worker's entrance.

>w
Worker's Entrance
As the workers file in, a young man yells at them to go faster. "If any'un sees you messin" around, you'll be outuvva job!" You didn't need any reminder of that.

>s
Locker Rooms
The first thing you notice as you walk into the locker rooms is the disgusting body odor radiating from every locker. You're unsure how to describe the sensation of the smell hitting your body: perhaps it slammed into your body? Either way, you're blinded momentarily by the horrid stench. After a few seconds that feel like an eternity, you regain your senses. You see the walls lined with tall metal lockers. A couple of benches are there on the ground for you to sit on while changing.

You can see three benches here.

* * *

>look
Locker Rooms
The first thing you notice as you walk into the locker rooms is the disgusting body odor radiating from every locker. You're unsure how to describe the sensation of the smell hitting your body: perhaps it slammed into your body? Either way, you're blinded momentarily by the horrid stench. After a few seconds that feel like an eternity, you regain your senses. You see the walls lined with tall metal lockers. A couple of benches are there on the ground for you to sit on while changing.

A broken locker stands hidden in the corner, it's lock damaged so badly that it no longer functions. You might be able to open this. 

You can see three benches here.

>examine the broken locker
The locker's lock is so badly broken that it no longer functions. You might be able to open this.

>open the broken locker
I shouldn't look into this in broad daylight - but I should come back later.

>wait
Time passes.

>n
Worker's Entrance
As the workers file in, a young man yells at them to go faster. "If any'un sees you messin" around, you'll be outuvva job!" You didn't need any reminder of that.

>e
Main Entrance
The hulking doors invite to swallow you in. You are hit by a gush of humid sweltry breeze - no, more than a breeze - it's the air you'll have to breathe now. "There won't be much to eat tonight," You think sardonically.

This isn't your entrance; this is for the factory elites - the owner, the overseer, and their friends. It's a privilege to use the main entrance. Wage workers like you have to go the long way through the worker's entrance.

>n
Front Gate
After about 15 minutes of walking, you finally show up at the factory front gate. Peeking through the clouds of smoke pouring from the chimneys, you can just barely tell that it's a sunny day.

You see all the other factory laborers slowly filing in, and sigh at the thought of having to start your 11 hour shift.

* * *

>w
Worker's Entrance
As the workers file in, a young man yells at them to go faster. "If any'un sees you messin" around, you'll be outuvva job!" You didn't need any reminder of that.

>s
Locker Rooms
The first thing you notice as you walk into the locker rooms is the disgusting body odor radiating from every locker. You're unsure how to describe the sensation of the smell hitting your body: perhaps it slammed into your body? Either way, you're blinded momentarily by the horrid stench. After a few seconds that feel like an eternity, you regain your senses. You see the walls lined with tall metal lockers. A couple of benches are there on the ground for you to sit on while changing.

A broken locker stands hidden in the corner, it's lock damaged so badly that it no longer functions. You might be able to open this. 

You can see three benches here.

>examine the broken locker
The locker's lock is so badly broken that it no longer functions. You might be able to open this.

* * *

>e
Front Gate
 After about 15 minutes of walking through a waking town, you have arrived at the factory front gate. Snakes of smoke pour from the high chimneys and hide the sun behind a screen of noxious white. The world lies in a dreamish haze. You see all the other factory laborers slowly filing in, and sigh at the thought of having to start your 11 hour shift.

>wait
Time passes.

I beg your pardon?

>wait
Time passes.

* * *

>e
Alley
You stumble from the darkness of the tenement into the gloomy alley. It's eerily quiet as this time of day, but in a few minutes you know the crowds will come pouring out from every household you can see. Perhaps you should move quickly to avoid the rush.

You pass a boy, yelling about the latest issue of the Boston Globe. He holds up the paper to your face and says "You want it, pal? Just 25 cents..." Your daily wage is about 50 cents. Is it really worth it?

I beg your pardon?

>s
You can't go that way.

>e
Front Gate
After about 15 minutes of walking, you finally show up at the factory front gate. Peeking through the clouds of smoke pouring from the chimneys, you can just barely tell that it's a sunny day.

You see all the other factory laborers slowly filing in, and sigh at the thought of having to start your 11 hour shift.

The sun falls below the horizon and the temperature drops abruptly to well below zero.

* * *

>wait
Time passes.

>w
Alley
You stumble from the darkness of the tenement into the gloomy alley. It's eerily quiet as this time of day, but in a few minutes you know the crowds will come pouring out from every household you can see. Perhaps you should move quickly to avoid the rush.

You pass a boy, yelling about the latest issue of the Boston Globe. He holds up the paper to your face and says "You want it, pal? Just 25 cents..." Your daily wage is about 50 cents. Is it really worth it?

>wait
Time passes.

* * *

>wait
Time passes.

The sun has passed across the sky and is on the verge of setting.

>e
Front Gate
After about 15 minutes of walking, you finally show up at the factory front gate. Peeking through the clouds of smoke pouring from the chimneys, you can just barely tell that it's a sunny day.

You see all the other factory laborers slowly filing in, and sigh at the thought of having to start your 11 hour shift.

>s
Main Entrance
The hulking doors invite to swallow you in. You are hit by a gush of humid sweltry breeze - no, more than a breeze - it's the air you'll have to breathe now. "There won't be much to eat tonight," You think sardonically.

This isn't your entrance; this is for the factory elites - the owner, the overseer, and their friends. It's a privilege to use the main entrance. Wage workers like you have to go the long way through the worker's entrance.

The sun falls below the horizon and the temperature drops abruptly to well below zero.

>w
Worker's Entrance
As the workers file in, a young man yells at them to go faster. "If any'un sees you messin" around, you'll be outuvva job!" You didn't need any reminder of that.

* * *

>close the broken locker
You close the broken locker.

>open the broken locker
You open the broken locker.

* * *

>wait
Time passes.

The sun has taken its journey through the sky and is on the verge of setting.

Tenement
You wake up to the drip of some cold water on your head. It's nothing unusual; the neighbors above have had a dilapidated floor for months now. It's amazing that it hasn't given in entirely. The unforgiving drops continue to pound mericlessly against your head - drilling in the miserly state of your surroundings. Swerving from the next oncoming drip, you adjust yourself, and observe other tenants in your room. Each of them are shells:  diminished beings curling, clutching themselves as if to hold on to the meager remains of their life-force in their cagey bodies. Clothes are a laugh at this point, looking more like throwaway rags than anything else. The dim rays of sunlight peek through the musty room, announcing the break of dawn. You force yourself out of bed. Work awaits.

Jones is the only other tenant that appears to be awake. It's only reasonable - how could he sleep? Nobody - not if they went through what he did. You feel the urge to approach him, but you're not sure if it's the right thing to do right now.

* * *

>wait
Time passes.

The sun has taken its journey through the sky and is on the verge of setting.

>e
You can't go that way.

>s
Main Entrance
 The Main Factory Door is wide open. You're surprised at first, but you recall that the Overseer has been forgetful about these kinds of things. You assume that he just forgot to close it.

>w
Worker's Entrance
  You feel an uncomfortably cold gust of wind cross your body as you approach the Worker's Entrance.

The sun falls below the horizon and the temperature plunges to well below zero.

>s
Locker Rooms
  The smell of the locker room is only slightly less horrendous at night - but the added darkness makes that smell all your mind can process. You see the walls lined with tall metal lockers. A couple of benches are there on the ground for you to sit on.

 The boy pulls the newspaper outof your face, saying "Oi, you can't look before ya buy!

 The boy pulls the newspaper outof your face, saying "Oi, you can't look before ya buy!

 The boy pulls the newspaper outof your face, saying "Oi, you can't look before ya buy!

>examine the metal lockers
You see some of the lockers are left open during the day. Unfortunately, it isn't the locker of anyone important. You take a peek through all of the doors and nothing of interest seems to be inside…

You try and peer through the small slits on each locker door, but ultimately the stench emanating stench is too much from each locker to investigate the closed lockers thoroughly.

That is, until you get to a lone damaged locker on the back right of the room. From afar, it looks as though it was locked, but as you get closer you see that the lock has actually been damaged and can now be opened.

>examine the brocken locker
That noun did not make sense in this context.

>examine the brocken locker
That noun did not make sense in this context.

>examine the broken locker
The locker's lock is so badly broken that it no longer functions. You might be able to open this.

>look in the broken locker
You can't see inside, since the broken locker is closed.

>open the broken locker
You open the broken locker.

>look in the brocken locker
You can't see any such thing.

* * *

>examine the broken locker
The locker's lock is so badly broken that it no longer functions. You might be able to open this.

>open the broken locker
You open the broken locker.  Lying on the bottom is a Mysterious Key.

>take the Mysterious Key
Taken.

>close the broken locker
You close the broken locker.

* * *

>s
Locker Rooms
  The smell of the locker room is only slightly less horrendous at night - but the added darkness makes that smell all your mind can process. You see the walls lined with tall metal lockers. A couple of benches are there on the ground for you to sit on.

 The boy pulls the newspaper outof your face, saying "Oi, you can't look before ya buy!

 The boy pulls the newspaper outof your face, saying "Oi, you can't look before ya buy!

 The boy pulls the newspaper outof your face, saying "Oi, you can't look before ya buy!

>i
You are carrying nothing.

>look
Locker Rooms
  The smell of the locker room is only slightly less horrendous at night - but the added darkness makes that smell all your mind can process. You see the walls lined with tall metal lockers. A couple of benches are there on the ground for you to sit on.

 The boy pulls the newspaper outof your face, saying "Oi, you can't look before ya buy!

 The boy pulls the newspaper outof your face, saying "Oi, you can't look before ya buy!

 The boy pulls the newspaper outof your face, saying "Oi, you can't look before ya buy!

* * *

>wait
Time passes.

The sun has taken its journey through the sky and is on the verge of setting.

>wait
Time passes.

The sun falls below the horizon and the temperature plunges to well below zero.

>wait
Time passes.

>s
Main Entrance
 The Main Factory Door is wide open. You're surprised at first, but you recall that the Overseer has been forgetful about these kinds of things. You assume that he just forgot to close it.

>w
Worker's Entrance
  You feel an uncomfortably cold gust of wind cross your body as you approach the Worker's Entrance.

>s
Locker Rooms
  The smell of the locker room is only slightly less horrendous at night - but the added darkness makes that smell all your mind can process. You see the walls lined with tall metal lockers. A couple of benches are there on the ground for you to sit on.

You can see three benches here.

>examine the metal lockers
You try and peer through the small slits on the closed locker doors, but ultimately the stench is too much from each locker to investigate them thoroughly.

Then, you examine the lockers that have been left open. Unfortunately, none of them are for anyone important. You take a peek through all of the doors and nothing of interest seems to be inside…

That is, until you get to a lone broken locker on the back right of the room. From afar, it looks as though it was locked, but as you get closer you see that the lock has actually been broken and can now be opened.

>look
Locker Rooms
The first thing you notice as you walk into the locker rooms is the disgusting body odor radiating from every locker. You're unsure how to describe the sensation of the smell hitting your body: perhaps it slammed into your body? Either way, you're blinded momentarily by the horrid stench. After a few seconds that feel like an eternity, you regain your senses. You see the walls lined with tall metal lockers. A couple of benches are there on the ground for you to sit on while changing.

A broken locker stands hidden in the corner, its lock damaged so badly that it no longer functions. You might be able to open this. 

You can see three benches here.

>examine the brocken locker
That noun did not make sense in this context.

* * *

>examine the broken locker
The locker's lock is so badly broken that it no longer functions. You might be able to open this.

>open the broken locker
You open the broken locker. Lying on the bottom is a Mysterious Key.

>take the mysterious key
Taken.

* * *

>e
Alley
  You stumble from the darkness of the tenement into the gloomy alley. It's eerily quiet as this time of day, but in a few minutes you know the crowds will come pouring out from every household you can see. Perhaps you should move quickly to avoid the rush. 

You pass a boy, yelling about the latest issue of the Boston Globe. He holds up the paper to your face and says "You want it, pal? Just 25 cents..." Your daily wage is about 50 cents. Is it really worth it?

The sun is now properly up.

>buy the paper
Well, there goes a quarter. This better be good.
a newspaper has been added to your inventory.

>i
You are carrying:
  a newspaper

>examine the paper
You see nothing special about paper.

>examine the newspaper
The paper is dated October 4, 1872. Seems to be a high end newspaper, because you can't understand many of the words. There is, however, one section that catches your eye.

"Cotton Gin Accident leaves Factory Worker Dead"

The paper then explained what had happened to Jones" wife. She got too close to the machine, the paper said, and before she knew it, it sucked her in and tore her apart. Only some of her remains were found.

You knew about this event well; it was in your own factory. But you hadn't seen the event take place, so it was interesting to see the details somewhere - especially when the company itself has been completely silent.

You doubt that it'll break the silence any time soon, either.

* * *

>buy the paper
Well, there goes a quarter. This better be good.
a newspaper has been added to your inventory.

>examine the paper
The paper is dated October 4, 1872. Seems to be a high end newspaper, because you can't understand many of the words. There is, however, one section that catches your eye.

"Cotton Gin Accident leaves Factory Worker Dead"

The paper then explained what had happened to Jones" wife. She got too close to the machine, the paper said, and before she knew it, it sucked her in and tore her apart. Only some of her remains were found.

You knew about this event well; it was in your own factory. But you hadn't seen the event take place, so it was interesting to see the details somewhere - especially when the company itself has been completely silent.

You doubt that it'll break the silence any time soon, either.

* * *

>i
You are carrying:
  a newspaper

>examine a newspaper
You see nothing special about the newspaper.

* * *

>drop the paper
You haven't got that.

>drop the newspaper
Dropped.

>look
Alley
You stumble from the darkness of the tenement into the gloomy alley. It's eerily quiet as this time of day, but in a few minutes you know the crowds will come pouring out from every household you can see. Perhaps you should move quickly to avoid the rush.

You pass a boy, yelling about the latest issue of the Boston Globe. He holds up the paper to your face and says "You want it, pal? Just 25 cents..." Your daily wage is about 50 cents. Is it really worth it?

You can also see a newspaper here.

>pick up the newspaper
Taken.

* * *

>buy the paper
Well, there goes a quarter. This better be good.
a newspaper has been added to your inventory.

>e
Front Gate
 After about 15 minutes of walking through a waking town, you have arrived at the factory front gate. Snakes of smoke pour from the high chimneys and hide the sun behind a screen of noxious white. The world lies in a dreamish haze. You see all the other factory laborers slowly filing in, and sigh at the thought of having to start your 11 hour shift.

* * *

>wait
Time passes.

The sun has taken its journey through the sky and is on the verge of setting.

>s
Main Entrance
  The Main Factory Door is wide open. You're surprised at first, but you recall that the Overseer has been forgetful about these kinds of things. You assume that he just forgot to close it.

* * *

>w
Worker's Entrance
  You feel an uncomfortably cold gust of wind cross your body as you approach the Worker's Entrance.

>s
Locker Rooms
  The smell of the locker room is only slightly less horrendous at night - but the added darkness makes that smell all your mind can process. You see the walls lined with tall metal lockers. A couple of benches are there on the ground for you to sit on.

  The paper is dated October 4, 1872. Seems to be a high end newspaper, because you can't understand many of the words. There is, however, one section that catches your eye.

"Cotton Gin Accident leaves Factory Worker Dead"

The paper then explained what had happened to Jones" wife. She got too close to the machine, the paper said, and before she knew it, it sucked her in and tore her apart. Only some of her remains were found.

You knew about this event well; it had happened in your own factory. But you hadn't seen the event take place, so it was interesting to see the details somewhere - especially when the company itself has been completely silent.

You doubt that it'll break the silence any time soon, either.

  The paper is dated October 4, 1872. Seems to be a high end newspaper, because you can't understand many of the words. There is, however, one section that catches your eye.

"Cotton Gin Accident leaves Factory Worker Dead"

The paper then explained what had happened to Jones" wife. She got too close to the machine, the paper said, and before she knew it, it sucked her in and tore her apart. Only some of her remains were found.

You knew about this event well; it had happened in your own factory. But you hadn't seen the event take place, so it was interesting to see the details somewhere - especially when the company itself has been completely silent.

You doubt that it'll break the silence any time soon, either.

  The paper is dated October 4, 1872. Seems to be a high end newspaper, because you can't understand many of the words. There is, however, one section that catches your eye.

"Cotton Gin Accident leaves Factory Worker Dead"

The paper then explained what had happened to Jones" wife. She got too close to the machine, the paper said, and before she knew it, it sucked her in and tore her apart. Only some of her remains were found.

You knew about this event well; it had happened in your own factory. But you hadn't seen the event take place, so it was interesting to see the details somewhere - especially when the company itself has been completely silent.

You doubt that it'll break the silence any time soon, either.

The sun falls below the horizon and the temperature plunges to well below zero.

* * *

>e
Alley
  You stumble from the darkness of the tenement into the gloomy alley. It's eerily quiet as this time of day, but in a few minutes you know the crowds will come pouring out from every household you can see. Perhaps you should move quickly to avoid the rush. 

You pass a boy, yelling about the latest issue of the Boston Globe. He holds up the paper to your face and says "You want it, pal? Just 25 cents..." Your daily wage is about 50 cents. Is it really worth it?

The sun is now properly up.

>examine the paper
The newspaper boy pulls the newspaper out of your face, saying "Oi, you can't look before ya buy!"

>buy the newspaper
Well, there goes your quarter. This better be good....

>examine the paper
The paper is dated October 4, 1872. Seems to be a high end newspaper, because you can't understand many of the words. There is, however, one section that catches your eye.

"Cotton Gin Accident leaves Factory Worker Dead"

The paper then explained what had happened to Jones" wife. She got too close to the machine, the paper said, and before she knew it, it sucked her in and tore her apart. Only some of her remains were found.

You knew about this event well; it was in your own factory. But you hadn't seen the event take place, so it was interesting to see the details somewhere - especially when the company itself has been completely silent.

You doubt that it'll break the silence any time soon, either.

>examine the newspaper
The paper is dated October 4, 1872. Seems to be a high end newspaper, because you can't understand many of the words. There is, however, one section that catches your eye.

"Cotton Gin Accident leaves Factory Worker Dead"

The paper then explained what had happened to Jones" wife. She got too close to the machine, the paper said, and before she knew it, it sucked her in and tore her apart. Only some of her remains were found.

You knew about this event well; it was in your own factory. But you hadn't seen the event take place, so it was interesting to see the details somewhere - especially when the company itself has been completely silent.

You doubt that it'll break the silence any time soon, either.

* * *

>e
Alley
  You stumble from the darkness of the tenement into the gloomy alley. It's eerily quiet as this time of day, but in a few minutes you know the crowds will come pouring out from every household you can see. Perhaps you should move quickly to avoid the rush. 

You pass a boy, yelling about the latest issue of the Boston Globe. He holds up the paper to your face and says "You want it, pal? Just 25 cents..." Your daily wage is about 50 cents. Is it really worth it?

The sun is now properly up.

>listen
You hear the crumpling of dry paper from the newspaper.

* * *

>e
Alley
  You stumble from the darkness of the tenement into the gloomy alley. It's eerily quiet as this time of day, but in a few minutes you know the crowds will come pouring out from every household you can see. Perhaps you should move quickly to avoid the rush. 

You pass a boy, yelling about the latest issue of the Boston Globe. He holds up the paper to your face and says "You want it, pal? Just 25 cents..." Your daily wage is about 50 cents. Is it really worth it?

The sun is now properly up.

>s
You can't go that way.

>e
Front Gate
After about 15 minutes of walking, you finally show up at the factory front gate. Peeking through the clouds of smoke pouring from the chimneys, you can just barely tell that it's a sunny day. You see all the other factory laborers slowly filing in, and sigh at the thought of having to start your 11 hour shift.

>s
Main Entrance
The hulking doors invite to swallow you in. You are hit by a gush of humid sweltry breeze - no, more than a breeze - it's the air you'll have to breathe now. "There won't be much to eat tonight," You think sardonically. This isn't your entrance; this is for the factory elites - the owner, the overseer, and their friends. It's a privilege to use the main entrance. Wage workers like you have to go the long way through the worker's entrance.

>s
Intake Desk
You see Jackie, the company secretary, staring at the wall in silence as she sits at her reception desk. She glances at you quickly, taking on a suspicious expression, but then looks back, as if she has better things to do. Suddenly, she notices that you're looking at the book on her desk. It's hard to see what the title is, but instinctively, she grabs it and shoves it into the nearest drawer, locking it with a key.

You can also see Overseer here.

The Overseer stomps over to you, yelling "What are you doing here! Get back to work, or I'll dock your pay for the rest of the month!"

Cotton Engines
As you work, the violent, periodic smashing of machinery forces itself in your head. You try to ignore it and focus on your cotton gin work, but every time you look at the thing, you can't help but picture what happened to Jones" wife. You shudder at the thought, and turn away from the machine for a bit, but there your boss is, staring in your soul with a furious glare. You turn back to the machine and keep working.

You can see Winston here.

Well that was rude. Guess I should avoid him next time.

* * *

>s
Main Entrance
The hulking doors invite to swallow you in. You are hit by a gush of humid sweltry breeze - no, more than a breeze - it's the air you'll have to breathe now. "There won't be much to eat tonight," You think sardonically. This isn't your entrance; this is for the factory elites - the owner, the overseer, and their friends. It's a privilege to use the main entrance. Wage workers like you have to go the long way through the worker's entrance.

>w
Worker's Entrance
As the workers file in, a young man yells at them to go faster. "If any'un sees you messin" around, you'll be outuvva job!" You didn't need any reminder of that.

* * *

>s
Locker Rooms
The first thing you notice as you walk into the locker rooms is the disgusting body odor radiating from every locker. You're unsure how to describe the sensation of the smell hitting your body: perhaps it slammed into your body? Either way, you're blinded momentarily by the horrid stench. After a few seconds that feel like an eternity, you regain your senses. You see the walls lined with tall metal lockers. A couple of benches are there on the ground for you to sit on while changing.

You can see three benches here.

>e
Cotton Engines
As you work, the violent, periodic smashing of machinery forces itself into your head. You try to ignore it and focus on your cotton gin work, but every time you look at the machine, you can't help but picture what happened to Jones" wife. You shudder at the thought, and turn away from it in disgust for a bit, but then you think of the Overseer. The Overseer wouldn't like to see you distracted from your work.

Your best friend, Winston, is working right next to you.

>talk to Winston
You come up to him and he gives you the lunch bag.

You see the Overseer looking around impatiently, almost wanting to find something wrong with the place.
The Overseer heads to the Spindle Room.

>talk to Winston
You come up to him and he gives you the lunch bag.

>i
You are carrying:
  a lunch bag

* * *

>e
Cotton Engines
As you work, the violent, periodic smashing of machinery forces itself into your head. You try to ignore it and focus on your cotton gin work, but every time you look at the machine, you can't help but picture what happened to Jones" wife. You shudder at the thought, and turn away from it in disgust for a bit, but then you think of the Overseer. The Overseer wouldn't like to see you distracted from your work.

Your best friend, Winston, is working right next to you.

>s
Central Stairs
You arrive at the stairwell. It's dimly lit and handrail-free, with grated metal stairs that seem like they could barely support one person. You can't make out much above or below you, but you do hear the violent whirring of cotton gin machines coming from directly below your feet.

The Overseer arrives from the Boiler Room and stomps over to you, yelling "What are you doing here! Get back to work, or I'll dock your pay for the rest of the month!" You hurry back to the cotton engines.

Cotton Engines
As you work, the violent, periodic smashing of machinery forces itself into your head. You try to ignore it and focus on your cotton gin work, but every time you look at the machine, you can't help but picture what happened to Jones" wife. You shudder at the thought, and turn away from it in disgust for a bit, but then you think of the Overseer. The Overseer wouldn't like to see you distracted from your work.

Your best friend, Winston, is working right next to you.

Well that was rude. Guess I should avoid him next time.

>wait
Time passes.

* * *

>wait
Time passes.

Overseer arrives from Central Stairs and glares at you.

>wait
Time passes.

You see the Overseer looking around impatiently, almost wanting to find something wrong with the place.

* * *

>wait
Time passes.

Overseer arrives from the Spindle Room and glares at you.

>wait
Time passes.

You see the Overseer looking around impatiently, almost wanting to find something wrong with the place.
The Overseer heads to the Spindle Room.

* * *

>wait
Time passes.

>wait
Time passes.

The sun has passed across the sky and is on the verge of setting.
Winston gives you a grim smile, and says "See ya tomorrow ya sod" as he heads out towards the Locker Rooms.
You pack up your things and make your way through the Worker's Entrance towards home. Whatever happens at night in the Factory, you're not sure if you want to be there to see it.

>wait
Time passes.

The sun falls below the horizon and the temperature drops abruptly to well below zero.

* * *

>e
Alley
  You stumble from the darkness of the tenement into the gloomy alley. It's eerily quiet as this time of day, but in a few minutes you know the crowds will come pouring out from every household you can see. Perhaps you should move quickly to avoid the rush. 

You pass a boy, yelling about the latest issue of the Boston Globe. He holds up the paper to your face and says "You want it, pal? Just 25 cents..." Your daily wage is about 50 cents. Is it really worth it?

The sun is now properly up.

I beg your pardon?

* * *

>w
Worker's Entrance
As the workers file in, a young man yells at them to go faster. "If any'un sees you messin" around, you'll be outuvva job!" You didn't need any reminder of that.

>s
Locker Rooms
The first thing you notice as you walk into the locker rooms is the disgusting body odor radiating from every locker. You're unsure how to describe the sensation of the smell hitting your body: perhaps it slammed into your body? Either way, you're blinded momentarily by the horrid stench. After a few seconds that feel like an eternity, you regain your senses. You see the walls lined with tall metal lockers. A couple of benches are there on the ground for you to sit on while changing.

You can see some closed lockers lined up across the wall.

Interestingly, alongside the closed lockers are some unaccompanied open ones.

You can also see lone locker and three benches here.

* * *

>e
Alley
  You stumble from the darkness of the tenement into the gloomy alley. It's eerily quiet as this time of day, but in a few minutes you know the crowds will come pouring out from every household you can see. Perhaps you should move quickly to avoid the rush. 

You pass a boy, yelling about the latest issue of the Boston Globe. He holds up the paper to your face and says "You want it, pal? Just 25 cents..." Your daily wage is about 50 cents. Is it really worth it?

The sun is now properly up.

>examine the newspaper
The boy pulls the newspaper outof your face, saying "Oi, you can't look before ya buy!

>e
Front Gate
 After about 15 minutes of walking through a waking town, you have arrived at the factory front gate. Snakes of smoke pour from the high chimneys and hide the sun behind a screen of noxious white. The world lies in a dreamish haze. You see all the other factory laborers slowly filing in, and sigh at the thought of having to start your 11 hour shift.

* * *

>wait
Time passes.

The sun has taken its journey through the sky and is on the verge of setting.

>look
Front Gate
 It's a rare sight to see the factory completely free of noxious smoke. You almost start feeling pleasant, but then you hear the echo of a loud crash. It seems like it came inside the factory. Suddenly, your mind races, as infinite fears - rational and irrational - cross your mind. Is the Overseer still here? Is someone getting killed? Are the machines acting up? You wonder if it's safe to be here at this hour.

>s
Main Entrance
  The Main Factory Door is wide open. You're surprised at first, but you recall that the Overseer has been forgetful about these kinds of things. You assume that he just forgot to close it.

* * *

>w
Worker's Entrance
  You feel an uncomfortably cold gust of wind cross your body as you approach the Worker's Entrance.

>s
Locker Rooms
  The smell of the locker room is only slightly less horrendous at night - but the added darkness makes that smell all your mind can process. You see the walls lined with tall metal lockers. A couple of benches are there on the ground for you to sit on.

The sun falls below the horizon and the temperature plunges to well below zero.

* * *

>look
Tenement
You wake up to the drip of some cold water on your head. It's nothing unusual; the neighbors above have had a dilapidated floor for months now. It's amazing that it hasn't given in entirely. The unforgiving drops continue to pound mericlessless against your head - drilling in the miserly state of your surroundings. Swerving from the next oncoming drip, you adjust yourself, you observe other tenants in your room. Each of them are shells:  diminished beings curling, clutching themselves as if to hold on to the meager remains of their life-force in their cagey bodies. Clothes are a laugh at this point, looking more like throwaway rags than anything else. The dim rays of incriminating sunlight cut its way through the musty room and announce the breaking of dawn. You force yourself out of bed. Work awaits.

Jones is the only other tenant that appears to be awake. It's only reasonable - how could he sleep? Nobody - not if they went through what he did. You feel the urge to approach him, but you're not sure if it's the right thing to do right now.

>map
That's not a verb I recognise.

* * *

>e
Alley
You stumble from the darkness of the tenement into the gloomy alley. It's eerily quiet as this time of day, but in a few minutes you know the crowds will come pouring out from every household you can see. Perhaps you should move quickly to avoid the rush.

You pass a boy, yelling about the latest issue of the Boston Globe. He holds up the paper to your face and says "You want it, pal? Just 25 cents..." Your daily wage is about 50 cents. Is it really worth it?

The sun is now properly up.

* * *

>look at Jones
You see nothing special about Jones.

>Examine jones
You see nothing special about Jones.

* * *

>read
(Jones)
You see nothing special about Jones.

>read the paper
You can't see any such thing.

>e
Alley
You stumble from the darkness of the tenement into the gloomy alley. It's eerily quiet as this time of day, but in a few minutes you know the crowds will come pouring out from every household you can see. Perhaps you should move quickly to avoid the rush.

You pass a newspaper boy, yelling about the latest issue of the Boston Globe. He holds up the paper to your face and says "You want it, pal? Just 25 cents..." Your daily wage is about 50 cents. Is it really worth it?

>read the paper
You see nothing special about paper.

>examine the newspaper
The paper is dated October 4, 1872. Seems to be a high end newspaper, because you can't understand many of the words. There is, however, one section that catches your eye.

"Cotton Gin Accident leaves Factory Worker Dead"

The paper then explained what had happened to Jones" wife. She got too close to the machine, the paper said, and before she knew it, it sucked her in and tore her apart. Only some of her remains were found.

You knew about this event well; it was in your own factory. But you hadn't seen the event take place, so it was interesting to see the details somewhere - especially when the company itself has been completely silent.

You doubt that it'll break the silence any time soon, either.

* * *

>best way to Cotton Engines
That's not a verb I recognise.

* * *

>east
Alley
You stumble from the darkness of the tenement into the gloomy alley. It's eerily quiet as this time of day, but in a few minutes you know the crowds will come pouring out from every household you can see. Perhaps you should move quickly to avoid the rush.

You pass a newspaper boy, yelling about the latest issue of the Boston Globe. He holds up the paper to your face and says "You want it, pal? Just 25 cents..." Your daily wage is about 50 cents. Is it really worth it?

>buy the newspaper
Well, there goes your quarter. This better be good....

>i
You are carrying:
  a newspaper

>examine paper
The paper is dated October 4, 1872. Seems to be a high end newspaper, because you can't understand many of the words. There is, however, one section that catches your eye.

"Cotton Gin Accident leaves Factory Worker Dead"

The paper then explained what had happened to Jones" wife. She got too close to the machine, the paper said, and before she knew it, it sucked her in and tore her apart. Only some of her remains were found.

You knew about this event well; it was in your own factory. But you hadn't seen the event take place, so it was interesting to see the details somewhere - especially when the company itself has been completely silent.

You doubt that it'll break the silence any time soon, either.

>examine newspaper
The paper is dated October 4, 1872. Seems to be a high end newspaper, because you can't understand many of the words. There is, however, one section that catches your eye.

"Cotton Gin Accident leaves Factory Worker Dead"

The paper then explained what had happened to Jones" wife. She got too close to the machine, the paper said, and before she knew it, it sucked her in and tore her apart. Only some of her remains were found.

You knew about this event well; it was in your own factory. But you hadn't seen the event take place, so it was interesting to see the details somewhere - especially when the company itself has been completely silent.

You doubt that it'll break the silence any time soon, either.

>e
Front Gate
After about 10 minutes of walking, you finally show up at the factory front gate. Peeking through the clouds of smoke pouring from the chimneys, you can just barely tell that it's a sunny day. You see all the other factory workers slowly filing in. Will you walk into the factory? As soon as you walk into the factory, you'll be starting your 11-hour shift.

>s
Main Entrance

>s
Intake Desk

>s
Spindle Room

* * *

>s
Central Stairs

* * *

>s
Boiler Room

>s
You can't go that way.

>w
You can't go that way.

>n
Central Stairs

* * *

>n
Main Entrance

>s
Intake Desk

* * *

>e
Loading Dock
You can see Overseer here.

You see the Overseer looking around impatiently, almost wanting to find something wrong with the place.
The Overseer stomps over to you, yelling "What are you doing here! Get back to work, or I'll dock your pay for the rest of the month!"

Cotton Engines
As you work, the violent, periodic smashing of machinery forces itself in your head. You try to ignore it and focus on your cotton gin work, but every time you look at the thing, you can't help but picture what happened to Jones" wife. You shudder at the thought, and turn away from the machine for a bit, but there your boss is, staring in your soul with a furious glare. You turn back to the machine and keep working. 5 hours later, the machine whirring stops for lunch break. You only have 10 minutes. You see your friend Winston in the other corner of the room. Being the (slightly) more well-off of you two, he has lunch for both of you.

You can see Winston here.

Well that was rude. Guess I should avoid him next time.

>wait
Time passes.

>e
Loading Dock
You can see Overseer here.

You see the Overseer looking around impatiently, almost wanting to find something wrong with the place.
The Overseer stomps over to you, yelling "What are you doing here! Get back to work, or I'll dock your pay for the rest of the month!"

Cotton Engines
As you work, the violent, periodic smashing of machinery forces itself in your head. You try to ignore it and focus on your cotton gin work, but every time you look at the thing, you can't help but picture what happened to Jones" wife. You shudder at the thought, and turn away from the machine for a bit, but there your boss is, staring in your soul with a furious glare. You turn back to the machine and keep working. 5 hours later, the machine whirring stops for lunch break. You only have 10 minutes. You see your friend Winston in the other corner of the room. Being the (slightly) more well-off of you two, he has lunch for both of you.

You can see Winston here.

Well that was rude. Guess I should avoid him next time.

* * *

>listen
Nothing of note.

>listen to the room
You can't see any such thing.

>e
Alley
You stumble from the darkness of the tenement into the gloomy alley. It's eerily quiet as this time of day, but in a few minutes you know the crowds will come pouring out from every household you can see. Perhaps you should move quickly to avoid the rush.

You pass a newspaper boy, yelling about the latest issue of the Boston Globe. He holds up the paper to your face and says "You want it, pal? Just 25 cents..." Your daily wage is about 50 cents. Is it really worth it?

>listen
Nothing of note.

>listen to the newspaper
From the newspaper you hear silence.

>listen to the paper
From paper you hear silence.

>listen to the Newspaper Bou
I only understood you as far as wanting to listen to the newspaper.

* * *

>listen to the room
You can't see any such thing.

>listen to the Tenement
You can't see any such thing.

>listen to Tenement
You can't see any such thing.

>e
Alley
You stumble from the darkness of the tenement into the gloomy alley. It's eerily quiet as this time of day, but in a few minutes you know the crowds will come pouring out from every household you can see. Perhaps you should move quickly to avoid the rush.

You pass a boy, yelling about the latest issue of the Boston Globe. He holds up the paper to your face and says "You want it, pal? Just 25 cents..." Your daily wage is about 50 cents. Is it really worth it?

>listen
Nothing of note.

* * *

>talk to Jones
You approach him, but he suddenly starts coughing hysterically, and gestures at you to move away. Maybe this isn't the best time to be talking to him, anyway.
Who?

* * *

>talk to jones
You approach him, but he suddenly starts coughing hysterically, and gestures at you to move away. Maybe this isn't the best time to be talking to him, anyway.

>talk to jones
You approach him, but he suddenly starts coughing hysterically, and gestures at you to move away. Maybe this isn't the best time to be talking to him, anyway.

>clear
(Jones)
Jones might not like that.

>e
Alley
You stumble from the darkness of the tenement into the gloomy alley. It's eerily quiet as this time of day, but in a few minutes you know the crowds will come pouring out from every household you can see. Perhaps you should move quickly to avoid the rush.

You pass a boy, yelling about the latest issue of the Boston Globe. He holds up the paper to your face and says "You want it, pal? Just 25 cents..." Your daily wage is about 50 cents. Is it really worth it?

>e
Front Gate
After about 10 minutes of walking, you finally show up at the factory front gate. Peeking through the clouds of smoke pouring from the chimneys, you can just barely tell that it's a sunny day. You see all the other factory workers slowly filing in. Will you walk into the factory? As soon as you walk into the factory, you'll be starting your 11-hour shift.

* * *

>s
Main Entrance

>s
Intake Desk
You see Jackie, the company secretary, staring at the wall in silence as she sits at her reception desk. She glances at you quickly, taking on a suspicious expression, but then looks back, as if she has better things to do. Suddenly, she notices that you're looking at the book on her desk. It's hard to see what the title is, but instinctively, she grabs it and shoves it into the nearest drawer, locking it with a key.

The Overseer arrives from the Spindle Room and stomps over to you, yelling "What are you doing here! Get back to work, or I'll dock your pay for the rest of the month!" You hurry back to the cotton engines.

Cotton Engines
As you work, the violent, periodic smashing of machinery forces itself in your head. You try to ignore it and focus on your cotton gin work, but every time you look at the thing, you can't help but picture what happened to Jones" wife. You shudder at the thought, and turn away from the machine for a bit, but there your boss is, staring in your soul with a furious glare. You turn back to the machine and keep working.

You can see Winston here.

Well that was rude. Guess I should avoid him next time.

>n
Spindle Room
You see Robin, who is (like usual) gossiping with her neighbor. She's trying to be discrete, but it's hard not to hear her when she has to speak over the roar of the machines to be heard by anyone. You can't make our every word, but maybe if you listen more carefully, you'll get to hear something interesting…

>n
Intake Desk
You see Jackie, the company secretary, staring at the wall in silence as she sits at her reception desk. She glances at you quickly, taking on a suspicious expression, but then looks back, as if she has better things to do. Suddenly, she notices that you're looking at the book on her desk. It's hard to see what the title is, but instinctively, she grabs it and shoves it into the nearest drawer, locking it with a key.

You can also see Overseer here.

The Overseer stomps over to you, yelling "What are you doing here! Get back to work, or I'll dock your pay for the rest of the month!" You scurry back to the cotton engines
Cotton Engines
As you work, the violent, periodic smashing of machinery forces itself in your head. You try to ignore it and focus on your cotton gin work, but every time you look at the thing, you can't help but picture what happened to Jones" wife. You shudder at the thought, and turn away from the machine for a bit, but there your boss is, staring in your soul with a furious glare. You turn back to the machine and keep working.

You can see Winston here.

Well that was rude. Guess I should avoid him next time.

>n
Spindle Room
You see Robin, who is (like usual) gossiping with her neighbor. She's trying to be discrete, but it's hard not to hear her when she has to speak over the roar of the machines to be heard by anyone. You can't make our every word, but maybe if you listen more carefully, you'll get to hear something interesting…

>s
Cotton Engines
As you work, the violent, periodic smashing of machinery forces itself in your head. You try to ignore it and focus on your cotton gin work, but every time you look at the thing, you can't help but picture what happened to Jones" wife. You shudder at the thought, and turn away from the machine for a bit, but there your boss is, staring in your soul with a furious glare. You turn back to the machine and keep working.

You can see Winston here.

>w
Locker Rooms

* * *

>n
You can't go that way.

>e
Main Entrance

>s
Intake Desk
You see Jackie, the company secretary, staring at the wall in silence as she sits at her reception desk. She glances at you quickly, taking on a suspicious expression, but then looks back, as if she has better things to do. Suddenly, she notices that you're looking at the book on her desk. It's hard to see what the title is, but instinctively, she grabs it and shoves it into the nearest drawer, locking it with a key.

You can also see Overseer here.

The Overseer stomps over to you, yelling "What are you doing here! Get back to work, or I'll dock your pay for the rest of the month!" You scurry back to the cotton engines
Cotton Engines
As you work, the violent, periodic smashing of machinery forces itself in your head. You try to ignore it and focus on your cotton gin work, but every time you look at the thing, you can't help but picture what happened to Jones" wife. You shudder at the thought, and turn away from the machine for a bit, but there your boss is, staring in your soul with a furious glare. You turn back to the machine and keep working.

You can see Winston here.

Well that was rude. Guess I should avoid him next time.

>wait
Time passes.

>wait
Time passes.

Overseer arrives from the Spindle Room and glares at you.

>n
Spindle Room
You see Robin, who is (like usual) gossiping with her neighbor. She's trying to be discrete, but it's hard not to hear her when she has to speak over the roar of the machines to be heard by anyone. You can't make our every word, but maybe if you listen more carefully, you'll get to hear something interesting…

>n
Intake Desk
You see Jackie, the company secretary, staring at the wall in silence as she sits at her reception desk. She glances at you quickly, taking on a suspicious expression, but then looks back, as if she has better things to do. Suddenly, she notices that you're looking at the book on her desk. It's hard to see what the title is, but instinctively, she grabs it and shoves it into the nearest drawer, locking it with a key.

Jackie, flustered, says "What are you doing here!?" I have some strong words for that Overseer of yours." and blows a small whistle.
The Overseer stalks into the room, clearly angry that he heard the whistle.

>s
Spindle Room
You see Robin, who is (like usual) gossiping with her neighbor. She's trying to be discrete, but it's hard not to hear her when she has to speak over the roar of the machines to be heard by anyone. You can't make our every word, but maybe if you listen more carefully, you'll get to hear something interesting…

>n
Intake Desk
You see Jackie, the company secretary, staring at the wall in silence as she sits at her reception desk. She glances at you quickly, taking on a suspicious expression, but then looks back, as if she has better things to do. Suddenly, she notices that you're looking at the book on her desk. It's hard to see what the title is, but instinctively, she grabs it and shoves it into the nearest drawer, locking it with a key.

You can also see Overseer here.

The Overseer stomps over to you, yelling "What are you doing here! Get back to work, or I'll dock your pay for the rest of the month!" You scurry back to the cotton engines
Cotton Engines
As you work, the violent, periodic smashing of machinery forces itself in your head. You try to ignore it and focus on your cotton gin work, but every time you look at the thing, you can't help but picture what happened to Jones" wife. You shudder at the thought, and turn away from the machine for a bit, but there your boss is, staring in your soul with a furious glare. You turn back to the machine and keep working.

You can see Winston here.

Well that was rude. Guess I should avoid him next time.

>clear
(Winston)
Winston might not like that.

* * *

>room e of
That's not a verb I recognise.

>room east of
That's not a verb I recognise.

>room east from Tenement
That's not a verb I recognise.

* * *

>look east
You make out the Alley that way.

>look north
You can't see anything promising that way.

>east
Alley
You stumble from the darkness of the tenement into the gloomy alley. It's eerily quiet as this time of day, but in a few minutes you know the crowds will come pouring out from every household you can see. Perhaps you should move quickly to avoid the rush.

You pass a boy, yelling about the latest issue of the Boston Globe. He holds up the paper to your face and says "You want it, pal? Just 25 cents..." Your daily wage is about 50 cents. Is it really worth it?

>look west
You make out the Tenement that way.

>look east
You make out the Front Gate that way.

* * *

>what time is it
That's not a verb I recognise.

>time
That's not a verb I recognise.

* * *

>examine the sun
The sun is now properly up.

>wait
Time passes.

* * *

>ait
That's not a verb I recognise.

>wai
That's not a verb I recognise.

>wait
Time passes.

The sun appears on the horizon.

* * *

>wait
Time passes.

The sun is now properly up.

>wait
Time passes.

* * *

>ait
That's not a verb I recognise.

>wait
Time passes.

>wait
Time passes.

The sun appears on the horizon.

>wait
Time passes.

The sun is now properly up.

* * *

I beg your pardon?

I beg your pardon?

>wait
Time passes.

The sun appears on the horizon.

* * *

>wait
Time passes.

The sun has passed across the sky and is on the verge of setting.

>wait
Time passes.

You collapse to your knees, mind buckling under the strain of what you have learned. Embrace the Madness.

* * *

>wait
Time passes.

>wait
Time passes.

The sun appears on the horizon.
Your continued exposure to the machine has driven you insane.

>wait
Time passes.

The sun is now properly up.

* * *

>wait
Time passes.

>clear
(Jones)
Jones might not like that.

* * *

>wait
Time passes.

The sun falls below the horizon and the temperature drops abruptly to well below zero.

>e
Alley
You stumble from the darkness of the tenement into the gloomy alley. It's eerily quiet as this time of day, but in a few minutes you know the crowds will come pouring out from every household you can see. Perhaps you should move quickly to avoid the rush.

You pass a boy, yelling about the latest issue of the Boston Globe. He holds up the paper to your face and says "You want it, pal? Just 25 cents..." Your daily wage is about 50 cents. Is it really worth it?

* * *

>look in the broken locker
You can't see inside, since the broken locker is closed.

* * *

>wait
Time passes.

>Include Basic Screen Effects by Emily Short.
That's not a verb I recognise.

>Include Basic Screen Effects by Emily Short.
That's not a verb I recognise.

>wait
Time passes.

>v
That's not a verb I recognise.

>wait
Time passes.

>e
Alley
You stumble from the darkness of the tenement into the gloomy alley. It's eerily quiet as this time of day, but in a few minutes you know the crowds will come pouring out from every household you can see. Perhaps you should move quickly to avoid the rush.

You pass a boy, yelling about the latest issue of the Boston Globe. He holds up the paper to your face and says "You want it, pal? Just 25 cents..." Your daily wage is about 50 cents. Is it really worth it?

>e
Front Gate
After about 15 minutes of walking, you finally show up at the factory front gate. Peeking through the clouds of smoke pouring from the chimneys, you can just barely tell that it's a sunny day. You see all the other factory laborers slowly filing in, and sigh at the thought of having to start your 11 hour shift.

* * *

>e
Cotton Engines
As you work, the violent, periodic smashing of machinery forces itself into your head. You try to ignore it and focus on your cotton gin work, but every time you look at the machine, you can't help but picture what happened to Jones" wife. You shudder at the thought, and turn away from it in disgust for a bit, but then you think of the Overseer. The Overseer wouldn't like to see you distracted from your work.

Your best friend, Winston, is working right next to you.

>wait
Time passes.

* * *

>wait
Time passes.

Overseer arrives from Central Stairs and glares at you.

>wai
That's not a verb I recognise.

>wait
Time passes.

You see the Overseer looking around impatiently, almost wanting to find something wrong with the place.

* * *

>wait
Time passes.

>wait
Time passes.

The sun has passed across the sky and is on the verge of setting.
Winston gives you a grim smile, and says "See ya tomorrow ya sod" as he heads out towards the Locker Rooms.

* * *

>ait
That's not a verb I recognise.

>ait
That's not a verb I recognise.

* * *

>wait
Time passes.

The sun is now properly up.

>wati
That's not a verb I recognise.

>wait
Time passes.

* * *

>wait
Time passes.

The sun is now properly up.

>e
Alley
You stumble from the darkness of the tenement into the gloomy alley. It's eerily quiet as this time of day, but in a few minutes you know the crowds will come pouring out from every household you can see. Perhaps you should move quickly to avoid the rush.

You pass a boy, yelling about the latest issue of the Boston Globe. He holds up the paper to your face and says "You want it, pal? Just 25 cents..." Your daily wage is about 50 cents. Is it really worth it?

* * *

>sit on the bench
You get onto the bench.

>lie down on the bench
That's not a verb I recognise.

>look
Locker Rooms (on the bench)
The first thing you notice as you walk into the locker rooms is the disgusting body odor radiating from every locker. You're unsure how to describe the sensation of the smell hitting your body: perhaps it slammed into your body? Either way, you're blinded momentarily by the horrid stench. After a few seconds that feel like an eternity, you regain your senses. You see the walls lined with tall metal lockers. A couple of benches are there on the ground for you to sit on while changing.

You can see two benches here.

>get off the bench
You get off the bench.

Locker Rooms
The first thing you notice as you walk into the locker rooms is the disgusting body odor radiating from every locker. You're unsure how to describe the sensation of the smell hitting your body: perhaps it slammed into your body? Either way, you're blinded momentarily by the horrid stench. After a few seconds that feel like an eternity, you regain your senses. You see the walls lined with tall metal lockers. A couple of benches are there on the ground for you to sit on while changing.

You can see three benches here.

* * *

>wait
Time passes.

The sun is now properly up.

>ait
That's not a verb I recognise.

* * *

>wait
Time passes.

The sun has passed across the sky and is on the verge of setting.

>e
Alley
You stumble from the darkness of the tenement into the gloomy alley. It's eerily quiet as this time of day, but in a few minutes you know the crowds will come pouring out from every household you can see. Perhaps you should move quickly to avoid the rush.

You pass a boy, yelling about the latest issue of the Boston Globe. He holds up the paper to your face and says "You want it, pal? Just 25 cents..." Your daily wage is about 50 cents. Is it really worth it?

The sun falls below the horizon and the temperature drops abruptly to well below zero.

>e
Front Gate
After about 15 minutes of walking, you finally show up at the factory front gate. Peeking through the clouds of smoke pouring from the chimneys, you can just barely tell that it's a sunny day.

You see all the other factory laborers slowly filing in, and sigh at the thought of having to start your 11 hour shift.

* * *

>s
Locker Rooms
The first thing you notice as you walk into the locker rooms is the disgusting body odor radiating from every locker. You're unsure how to describe the sensation of the smell hitting your body: perhaps it slammed into your body? Either way, you're blinded momentarily by the horrid stench. After a few seconds that feel like an eternity, you regain your senses. You see the walls lined with tall metal lockers. A couple of benches are there on the ground for you to sit on while changing.

You can see three benches here.

>examine the locker
The locker's lock is so badly broken that it no longer functions. You might be able to open this.

>examine the metal lockers
You see some of the lockers are left open during the day. Unfortunately, it isn't the locker of anyone important. You take a peek through all of the doors and nothing of interest seems to be inside…

You try and peer through the small slits on each locker door, but ultimately the stench emanating stench is too much from each locker to investigate the closed lockers thoroughly.

That is, until you get to a lone damaged locker on the back right of the room. From afar, it looks as though it was locked, but as you get closer you see that the lock has actually been damaged and can now be opened.

* * *

>look
Locker Rooms
The first thing you notice as you walk into the locker rooms is the disgusting body odor radiating from every locker. You're unsure how to describe the sensation of the smell hitting your body: perhaps it slammed into your body? Either way, you're blinded momentarily by the horrid stench. After a few seconds that feel like an eternity, you regain your senses. You see the walls lined with tall metal lockers. A couple of benches are there on the ground for you to sit on while changing.

A broken locker stands hidden in the corner, it's lock damaged so badly that it no longer functions. You might be able to open this. 

You can see three benches here.

>look at the damaged locker
You can't see any such thing.

>take the Mysterious key
You can't see any such thing.

>look in the broken locker
You can't see inside, since the broken locker is closed.

* * *

>look in the brocken locker
You can't see any such thing.

>take the mysterious key
You can't see any such thing.

>look in the broken locker
You can't see inside, since the broken locker is closed.

* * *

>time of day
That's not a verb I recognise.

* * *

>status
That's not a verb I recognise.

>wait
Time passes.

* * *

>e
Alley
You stumble from the darkness of the tenement into the gloomy alley. It's eerily quiet as this time of day, but in a few minutes you know the crowds will come pouring out from every household you can see. Perhaps you should move quickly to avoid the rush.

You pass a boy, yelling about the latest issue of the Boston Globe. He holds up the paper to your face and says "You want it, pal? Just 25 cents..." Your daily wage is about 50 cents. Is it really worth it?

>s
You can't go that way.

* * *

>A weekday is a kind of value. The weekdays are Saturday, Sunday, Monday, Tuesday, Wednesday, Thursday, Friday. The current weekday is a weekday that varies. The current weekday is Saturday.
You seem to want to talk to someone, but I can't see whom.

>wai
That's not a verb I recognise.

* * *

>examine
(the Alley)
You make out the Alley that way.

* * *

>talk to Jones
You approach him, but he suddenly starts coughing hysterically, and gestures at you to move away. Maybe this isn't the best time to be talking to him, anyway.

>talk to Jones
You approach him, but he suddenly starts coughing hysterically, and gestures at you to move away. Maybe this isn't the best time to be talking to him, anyway.

* * *

>shout to Jordan
You can't see any such thing.

>shout at Jones
(to Jones)
There is no reply.

>shout to Jones
You approach him, but he suddenly starts coughing hysterically, and gestures at you to move away. Maybe this isn't the best time to be talking to him, anyway.

>shout to Jones
You approach him, but he suddenly starts coughing hysterically, and gestures at you to move away. Maybe this isn't the best time to be talking to him, anyway.

>ask Jones
You approach him, but he suddenly starts coughing hysterically, and gestures at you to move away. Maybe this isn't the best time to be talking to him, anyway.

The sun is now properly up.

>ask Hones
You can't see any such thing.

>ask Jones
You approach him, but he suddenly starts coughing hysterically, and gestures at you to move away. Maybe this isn't the best time to be talking to him, anyway.

* * *

>look n
You can't see anything promising that way.

>look e
You make out the Alley that way.

* * *

>wait wait
I only understood you as far as wanting to wait.

>wait
Time passes.

The sun is now properly up.

* * *

>s
Locker Rooms
The first thing you notice as you walk into the locker rooms is the disgusting body odor radiating from every locker. You're unsure how to describe the sensation of the smell hitting your body: perhaps it slammed into your body? Either way, you're blinded momentarily by the horrid stench. After a few seconds that feel like an eternity, you regain your senses. You see the walls lined with tall metal lockers. A couple of benches are there on the ground for you to sit on while changing.

You can see three benches here.

>e
Cotton Engines
As you work, the violent, periodic smashing of machinery forces itself into your head. You try to ignore it and focus on your cotton gin work, but every time you look at the machine, you can't help but picture what happened to Jones" wife. You shudder at the thought, and turn away from it in disgust for a bit, but then you think of the Overseer. The Overseer wouldn't like to see you distracted from your work.

You see the Overseer. The Overseer is heavy and muscular, with a large white beard and eyes you can barely make out, what with all the bags and wrinkles covering them up. He's somehow intimidating, despite the fact that it seems like his body could fall apart any second.

Your best friend, Winston, is working right next to you.

You see the Overseer looking around impatiently, almost wanting to find something wrong with the place.
The Overseer heads to the Loading Dock.

>wait
Time passes.

Overseer arrives from the Loading Dock and glares at you.

>wait
Time passes.

You see the Overseer looking around impatiently, almost wanting to find something wrong with the place.
The Overseer heads to Central Stairs.

* * *

>wait
Time passes.

Overseer arrives from Central Stairs and glares at you.

>wait
Time passes.

You see the Overseer looking around impatiently, almost wanting to find something wrong with the place.
The Overseer heads to the Spindle Room.

The sun has passed across the sky and is on the verge of setting.
Winston gives you a grim smile, and says "See ya tomorrow ya sod" as he heads out towards the Locker Rooms.

You pack up your things and make your way through the Worker's Entrance towards home. Whatever happens at night in the Factory, you're not sure if you want to be there to see it.

Hit SPACE to continue.

* * *

>wait
Time passes.

The sun falls below the horizon and the temperature drops abruptly to well below zero.

* * *

>sleep
You rest your eyes, but you can't get yourself to go to sleep. Maybe try again later.

>wait
Time passes.

The sun is now properly up.

>it
That's not a verb I recognise.

>ait
That's not a verb I recognise.

* * *

>wait
Time passes.

>sleep
This isn't an appropriate time and place to be sleeping.

* * *

>sleep
You rest your eyes, but you can't get yourself to go to sleep. Maybe try again later.

>e
Alley
You stumble from the darkness of the tenement into the gloomy alley. It's eerily quiet as this time of day, but in a few minutes you know the crowds will come pouring out from every household you can see. Perhaps you should move quickly to avoid the rush.

You pass a boy, yelling about the latest issue of the Boston Globe. He holds up the paper to your face and says "You want it, pal? Just 25 cents..." Your daily wage is about 50 cents. Is it really worth it?

The sun is now properly up.

>wait
Time passes.

>it
That's not a verb I recognise.

>wait
Time passes.

* * *

>s
Main Entrance
The hulking doors invite to swallow you in. You are hit by a gush of humid sweltry breeze - no, more than a breeze - it's the air you'll have to breathe now. "There won't be much to eat tonight," You think sardonically.

This isn't your entrance; this is for the factory elites - the owner, the overseer, and their friends. It's a privilege to use the main entrance. Wage workers like you have to go the long way through the worker's entrance.

>s
Intake Desk
You can see a desk chair and a reception desk (in which is a drawer (in which is a book)) here.